You are an intelligent scientist who has invented a prototype watch that allows you to travel 40 years into the future. You have exactly an hour and a half in the future day before your watch teleports you back home. In the mean time, you can do anything your heart desires, but use your time wisely!

You have successfully teleported into the future. Keep an eye on your watch at all times.

"Whoa!!!" you say. "I guess this is what my laboratory will look like 40 years from now… How magnificent!⼅d" 
Make sure you remember to put significnt items inside your backpack to bring back with you later on.

Into The Future
An Interactive Fiction by Tyler Makabe
Release 1 / Serial number 130318 / Inform 7 build 6G60 (I6/v6.32 lib 6/12N) SD

Lab Room
It is very gloomy in here with its spherical lights. You can vaguely see equpiment that you have in your very own lab room as well. The desks are covered in cob webs. The lab shelves are high up with shiny objects on the top. The walls are completely white with faded designs on them.
The outback dump is to the south, pristine library is to the east, garage to the west, and aurora walk is to the north.

I beg your pardon?

>w
Garage
This must be someone's garage. Definately not yours, that's for sure. Many intricate tools and devices hang from the walls and racks. A marvelous car is parked in the middle of it!
The lab room is to the east, floating sidewalk to the west, tech building to the north, and obscure parking lot to the south.

>w
Floating Sidewalk
A luminated clear pathway slowly elevates as you walk farther up onto it. Metal handbars line the edges of the clear floating path. It feels as if you're walking on a cloud, but looks like a beam of light!
The garage is to the east, the lockdown to the west, thrift shop to the north, and directional path to the south.

>s
Directional Path
You are now on cement again. The texture of this pathway is much different from the Floating Sidewalk. A brown silk bag is lying on the side of the pathway.
The floating sidewalk is to the north, and elevator shaft to the south.

>s
Elevator Shaft
Yellow tape borders the edges of the elevator to the west. Near the elevator shaft are scissors probably left out by the workers. Seems as though the elevator is out of function and the workers are on their lunch break.
The obscure parking lot is to the east, and directional path to the north.

>n
Directional Path
You are now on cement again. The texture of this pathway is much different from the Floating Sidewalk. A brown silk bag is lying on the side of the pathway.
The floating sidewalk is to the north, and elevator shaft to the south.

>x bag
A brown bag made out of soft silk. The designs on the bag is of a face of an old man with grey hair and glasses.

>open bag
You open the bag, revealing Pepto Bismol and Pin.

>x pin
A small, yet extremely sharp pin that is a turquoise color.

>take pin
Ouch! You poked yourself on accident.

Taken.

>take bismol
This looks like you can give it to someone to treat their sickness.

* * *

>w
Garage
This must be someone's garage. Definately not yours, that's for sure. Many intricate tools and devices hang from the walls and racks. A marvelous car is parked in the middle of it!
The lab room is to the east, floating sidewalk to the west, tech building to the north, and obscure parking lot to the south.

* * *

>s
Directional Path
You are now on cement again. The texture of this pathway is much different from the Floating Sidewalk. A brown silk bag is lying on the side of the pathway.
The floating sidewalk is to the north, and elevator shaft to the south.

>x bag
A brown bag made out of soft silk. The designs on the bag is of a face of an old man with grey hair and glasses.

>open bag
You open the bag, revealing .

>x bismol
Pink liquid inside a bottle that someone can drink to clear up indigestion and heartburn.

>drink bismol
It tastes like a mint candy, but doesn't settle too well in your stomach.

There's nothing suitable to drink here.

>undo
Directional Path
[Previous turn undone.]

>undo
Directional Path
[Previous turn undone.]

>udno
That's not a verb I recognise.

>undo
Directional Path
[Previous turn undone.]

>w
You can't go that way.

>n
Floating Sidewalk
A luminated clear pathway slowly elevates as you walk farther up onto it. Metal handbars line the edges of the clear floating path. It feels as if you're walking on a cloud, but looks like a beam of light!
The garage is to the east, the lockdown to the west, thrift shop to the north, and directional path to the south.

>s
Directional Path
You are now on cement again. The texture of this pathway is much different from the Floating Sidewalk. A brown silk bag is lying on the side of the pathway.
The floating sidewalk is to the north, and elevator shaft to the south.

* * *

>x bag
A brown bag made out of soft silk. The designs on the bag is of a face of an old man with grey hair and glasses.

>open bag
That's already open.

* * *

>w
Garage
This must be someone's garage. Definately not yours, that's for sure. Many intricate tools and devices hang from the walls and racks. A marvelous car is parked in the middle of it!
The lab room is to the east, floating sidewalk to the west, tech building to the north, and obscure parking lot to the south.

>s
Obscure Parking Lot
An eighteen foot parking structure that allows you to park your car whenever you want.
The garage is to the north, elevator shaft to the west, and skyscraper 057 to the east.

>w
Elevator Shaft
Yellow tape borders the edges of the elevator to the west. Near the elevator shaft are scissors probably left out by the workers. Seems as though the elevator is out of function and the workers are on their lunch break.
The obscure parking lot is to the east, and directional path to the north.

>s
You can't go that way.

>n
Directional Path
You are now on cement again. The texture of this pathway is much different from the Floating Sidewalk. A brown silk bag is lying on the side of the pathway.
The floating sidewalk is to the north, and elevator shaft to the south.

* * *

>open bag
You open the bag, revealing Pepto Bismol and Pin.

>x pepto bismol
Pink liquid inside a bottle that someone can drink to clear up indigestion and heartburn.

>take pepto bismol
This looks like you can give it to someone to treat their sickness.

>take pin
Ouch! You poked yourself on accident.

Taken.

>i
You are carrying:
  Pin
  an orange backpack (open but empty)
  White shirt
  Jeans
  Glasses
  Prototype watch

>e
You can't go that way.

>n
Floating Sidewalk
A luminated clear pathway slowly elevates as you walk farther up onto it. Metal handbars line the edges of the clear floating path. It feels as if you're walking on a cloud, but looks like a beam of light!
The garage is to the east, the lockdown to the west, thrift shop to the north, and directional path to the south.

>e
Garage
This must be someone's garage. Definately not yours, that's for sure. Many intricate tools and devices hang from the walls and racks. A marvelous car is parked in the middle of it!
The lab room is to the east, floating sidewalk to the west, tech building to the north, and obscure parking lot to the south.

>x car
Such an incredible piece of work! The car is slick and skinny. A white coat of paint is layered on the whole car and you can even see your own reflection! A black trim goes all around the sides, with blue tinted windows. Surprisingly there are no tires, and exhaust pipes stick out from the back of the car A fairly large bar code is inscribed on the trunk.

>x car
Such an incredible piece of work! The car is slick and skinny. A white coat of paint is layered on the whole car and you can even see your own reflection! A black trim goes all around the sides, with blue tinted windows. Surprisingly there are no tires, and exhaust pipes stick out from the back of the car A fairly large bar code is inscribed on the trunk.

* * *

>w
Garage
This must be someone's garage. Definately not yours, that's for sure. Many intricate tools and devices hang from the walls and racks. A marvelous car is parked in the middle of it!
The lab room is to the east, floating sidewalk to the west, tech building to the north, and obscure parking lot to the south.

>take machete
Not too sure what you'd need a machete for, but whatever. Looks like it can easily break through glass very easily.

Taken.

>hit car with machete
(first taking Car)
You hit the luxurious car with full force. The car ends up exploding as you hit it causing shattered pieces of glass to pierce through all parts of your body.

    *** You have died ***

In that game you scored 0 out of a possible 1500, in 3 turns.

Would you like to RESTART, RESTORE a saved game, QUIT or UNDO the last command?

>use machete to hit car
Please give one of the answers above.

Would you like to RESTART, RESTORE a saved game, QUIT or UNDO the last command?

>take machete
Please give one of the answers above.

Would you like to RESTART, RESTORE a saved game, QUIT or UNDO the last command?

>take machete
Please give one of the answers above.

Would you like to RESTART, RESTORE a saved game, QUIT or UNDO the last command?

>i
Please give one of the answers above.

Would you like to RESTART, RESTORE a saved game, QUIT or UNDO the last command?

>take machete
Please give one of the answers above.

Would you like to RESTART, RESTORE a saved game, QUIT or UNDO the last command?

>break car
Please give one of the answers above.

Would you like to RESTART, RESTORE a saved game, QUIT or UNDO the last command?

>restart
You are an intelligent scientist who has invented a prototype watch that allows you to travel 40 years into the future. You have exactly an hour and a half in the future day before your watch teleports you back home. In the mean time, you can do anything your heart desires, but use your time wisely!

You have successfully teleported into the future. Keep an eye on your watch at all times.

"Whoa!!!" you say. "I guess this is what my laboratory will look like 40 years from now… How magnificent!" 
Make sure you remember to put significnt items inside your backpack to bring back with you later on.

Into The Future
An Interactive Fiction by Tyler Makabe
Release 1 / Serial number 130318 / Inform 7 build 6G60 (I6/v6.32 lib 6/12N) SD

Lab Room
It is very gloomy in here with its spherical lights. You can vaguely see equpiment that you have in your very own lab room as well. The desks and chairs are covered in cob webs. The lab shelves are high up with shiny objects on the top. The walls are completely white with faded designs on them.
The outback dump is to the south, pristine library is to the east, garage to the west, and aurora walk is to the north.

>w
Garage
This must be someone's garage. Definately not yours, that's for sure. Many intricate tools and devices hang from the walls and racks. A marvelous car is parked in the middle of it!
The lab room is to the east, floating sidewalk to the west, tech building to the north, and obscure parking lot to the south.

>x machete
A broad, large blade with a dark red glow on the ends of it.

>take machete
Not too sure what you'd need a machete for, but whatever. Looks like it can easily break through glass very easily.

Taken.

>break car with machete
(first taking Car)
You hit the luxurious car with full force. The car ends up exploding as you hit it causing shattered pieces of glass to pierce through all parts of your body.

    *** You have died ***

In that game you scored 0 out of a possible 1500, in 4 turns.

Would you like to RESTART, RESTORE a saved game, QUIT or UNDO the last command?

>undo
Garage
[Previous turn undone.]

>hit car with machete
(first taking Car)
You hit the luxurious car with full force. The car ends up exploding as you hit it causing shattered pieces of glass to pierce through all parts of your body.

    *** You have died ***

In that game you scored 0 out of a possible 1500, in 4 turns.

Would you like to RESTART, RESTORE a saved game, QUIT or UNDO the last command?

* * *

>w
Garage
This must be someone's garage. Definately not yours, that's for sure. Many intricate tools and devices hang from the walls and racks. A marvelous car is parked in the middle of it!
The lab room is to the east, floating sidewalk to the west, tech building to the north, and obscure parking lot to the south.

>e
Lab Room
It is very gloomy in here with its spherical lights. You can vaguely see equpiment that you have in your very own lab room as well. The desks are covered in cob webs. The lab shelves are high up with shiny objects on the top. The walls are completely white with faded designs on them.
The outback dump is to the south, pristine library is to the east, garage to the west, and aurora walk is to the north.

>n
Aurora Walk
This seems to be the main walkway for many people. It is busy and lots of rubbish is littered on the ground. A trash can is always available yet no one has the decency to throw the trash into it. The ground is made up of a thick green cushiony pad. Many of the pedestrians are walking by and minding their own buisiness.
The lab room is to the south, facial salon to the east, tech building to the west, and DNA beach to the north.

>n
DNA Beach
Surfs-up! Seems as though everyone's at the beach today. A sign shows the reports of the day. Many beach blankets cover the bed of sand. A red box lies underneath the analysis sign.
The aurora walk is to the south, sandy ocean to the north, and cruising shack to the east.

* * *

>s
Aurora Walk
This seems to be the main walkway for many people. It is busy and lots of rubbish is littered on the ground. A trash can is always available yet no one has the decency to throw the trash into it. The ground is made up of a thick green cushiony pad. Many of the pedestrians are walking by and minding their own buisiness.
The lab room is to the south, facial salon to the east, tech building to the west, and DNA beach to the north.

>e
Facial Salon
There is an aroma of strawberry that surrounds the salon. Lots of thin silk and hair is scattered all over the checker-board floor and tabletops. The fancy light blue lights gives the room a nice "cool" feeling to it. Silk seems to have been excreted from the tiny holes of the lights for some reason. White leather seats around the mirrors make up almost the entire salon.
The aurora walk is to the west, and pristine library to the south.

>sit in seat
Nice and comfy! Good way to relieve the stress off of your feet.

[Your score has just gone up by fifteen points.]

>w
Aurora Walk
This seems to be the main walkway for many people. It is busy and lots of rubbish is littered on the ground. A trash can is always available yet no one has the decency to throw the trash into it. The ground is made up of a thick green cushiony pad. Many of the pedestrians are walking by and minding their own buisiness.
The lab room is to the south, facial salon to the east, tech building to the west, and DNA beach to the north.

>w
Tech Building
A Medium Sized robot is the only thing on the floor around the building. Programers are focused on their work on building more of these robots.
The garage is to the south, aurora walk to the east, and thrift shop to the west.

You can see Medium Sized Robot here.

>w
Thrift Shop
An old-school, yet reimaged look of a Thirft Shop. The racks of clothes and hangers automatically rotate once you are done looking at them. Most of the stuff here dates back to 2010. Looks fairly brand new and in style.
The tech building is to the east, and floating sidewalk to the south.

>s
Floating Sidewalk
A luminated clear pathway slowly elevates as you walk farther up onto it. Metal handbars line the edges of the clear floating path. It feels as if you're walking on a cloud, but looks like a beam of light!
The garage is to the east, the lockdown to the west, thrift shop to the north, and directional path to the south.

>s
Directional Path
You are now on cement again. The texture of this pathway is much different from the Floating Sidewalk. A brown silk bag is lying on the side of the pathway.
The floating sidewalk is to the north, and elevator shaft to the south.

* * *

>open bag
You open the bag, revealing Pepto Bismol and Pin.

>take bismol
This looks like you can give it to someone to treat their sickness.

>drink bismol
It tastes like a mint candy, but doesn't settle too well in your stomach.

There's nothing suitable to drink here.

* * *

>n
Aurora Walk
This seems to be the main walkway for many people. It is busy and lots of rubbish is littered on the ground. A trash can is always available yet no one has the decency to throw the trash into it. The ground is made up of a thick green cushiony pad. Many of the pedestrians are walking by and minding their own buisiness.
The lab room is to the south, facial salon to the east, tech building to the west, and DNA beach to the north.

I beg your pardon?

>w
Tech Building
A Medium Sized robot is the only thing on the floor around the building. Programers are focused on their work on building more of these robots.
The garage is to the south, aurora walk to the east, and thrift shop to the west.

You can see Medium Sized Robot here.

* * *

>w
Floating Sidewalk
A luminated clear pathway slowly elevates as you walk farther up onto it. Metal handbars line the edges of the clear floating path. It feels as if you're walking on a cloud, but looks like a beam of light!
The garage is to the east, the lockdown to the west, thrift shop to the north, and directional path to the south.

* * *

>s
Directional Path
You are now on cement again. The texture of this pathway is much different from the Floating Sidewalk. A brown silk bag is lying on the side of the pathway.
The floating sidewalk is to the north, and elevator shaft to the south.

>w
You can't go that way.

* * *

>n
Floating Sidewalk
A luminated clear pathway slowly elevates as you walk farther up onto it. Metal handbars line the edges of the clear floating path. It feels as if you're walking on a cloud, but looks like a beam of light!
The garage is to the east, the lockdown to the west, thrift shop to the north, and directional path to the south.

>w
Lockdown
The prison cells are extremely small. The whole entire Lockdown contain chunks of the luminated steel that emerge from underneath the ground, and move guards toward each cell. The cell bars and walls are also made out of the same material as the floor. At least twenty guards are lined up around each corner of the jail.
The floating sidewalk is to the east.

>s
You can't go that way.

>e
Floating Sidewalk
A luminated clear pathway slowly elevates as you walk farther up onto it. Metal handbars line the edges of the clear floating path. It feels as if you're walking on a cloud, but looks like a beam of light!
The garage is to the east, the lockdown to the west, thrift shop to the north, and directional path to the south.

>s
Directional Path
You are now on cement again. The texture of this pathway is much different from the Floating Sidewalk. A brown silk bag is lying on the side of the pathway.
The floating sidewalk is to the north, and elevator shaft to the south.

* * *

>s
Elevator Shaft
Yellow tape borders the edges of the elevator to the west. Near the elevator shaft are scissors probably left out by the workers. Seems as though the elevator is out of function and the workers are on their lunch break.
The obscure parking lot is to the east, and directional path to the north.

>m
That's not a verb I recognise.

>n
Directional Path
You are now on cement again. The texture of this pathway is much different from the Floating Sidewalk. A brown silk bag is lying on the side of the pathway.
The floating sidewalk is to the north, and elevator shaft to the south.

* * *

>x pepto bismol
Pink liquid inside a bottle that someone can drink to clear up indigestion and heartburn.

>drink pepto bismol
It tastes like a mint candy, but doesn't settle too well in your stomach.

* * *

>s
Floating Sidewalk
A luminated clear pathway slowly elevates as you walk farther up onto it. Metal handbars line the edges of the clear floating path. It feels as if you're walking on a cloud, but looks like a beam of light!
The garage is to the east, the lockdown to the west, thrift shop to the north, and directional path to the south.

>w
Lockdown
The prison cells are extremely small. The whole entire Lockdown contain chunks of the luminated steel that emerge from underneath the ground, and move guards toward each cell. The cell bars and walls are also made out of the same material as the floor. At least twenty guards are lined up around each corner of the jail. One of the guards
The floating sidewalk is to the east.

>x prison cell
Contains cell bars, walls, and bed for the prisoner. Not very luxurious but suitable for reprobates. 
There seems to be a pocket knife and saw here too.

>take knife
Taken.

>e
Floating Sidewalk
A luminated clear pathway slowly elevates as you walk farther up onto it. Metal handbars line the edges of the clear floating path. It feels as if you're walking on a cloud, but looks like a beam of light!
The garage is to the east, the lockdown to the west, thrift shop to the north, and directional path to the south.

>e
Garage
This must be someone's garage. Definately not yours, that's for sure. Many intricate tools and devices hang from the walls and racks. A marvelous car is parked in the middle of it!
The lab room is to the east, floating sidewalk to the west, tech building to the north, and obscure parking lot to the south.

Such an incredible piece of work! The car is slick and skinny. A white coat of paint is layered on the whole car and you can even see your own reflection! A black trim goes all around the sides, with blue tinted windows. Surprisingly there are no tires, and exhaust pipes stick out from the back of the car A fairly large bar code is inscribed on the trunk.

>n
Tech Building
A Medium Sized robot is the only thing on the floor around the building. Programers are focused on their work on building more of these robots.
The garage is to the south, aurora walk to the east, and thrift shop to the west.

You can see Medium Sized Robot here.

* * *

>e
Cruising Shack
An open cabin made out of wooden planks. A cashier runs the whole place, while people go in and out, grabbing beach gear from the automatic moving beach shelf. Looks like you can just borrow the gear instead of paying.
The DNA Beach is to the west.

Sunny is leaning on the counter inside the Shack waiting for someone to ask for assistance.

>take plank
Taken.

>cut plank with knife
Why would you cut that?

* * *

>x prison cell
Contains cell bars, walls, and bed for the prisoner. Not very luxurious but suitable for reprobates. 
There seems to be a pocket knife and saw here too.

>take saw
Taken.

>e
Floating Sidewalk
A luminated clear pathway slowly elevates as you walk farther up onto it. Metal handbars line the edges of the clear floating path. It feels as if you're walking on a cloud, but looks like a beam of light!
The garage is to the east, the lockdown to the west, thrift shop to the north, and directional path to the south.

I beg your pardon?

>e
Garage
This must be someone's garage. Definately not yours, that's for sure. Many intricate tools and devices hang from the walls and racks. A marvelous car is parked in the middle of it!
The lab room is to the east, floating sidewalk to the west, tech building to the north, and obscure parking lot to the south.

Such an incredible piece of work! The car is slick and skinny. A white coat of paint is layered on the whole car and you can even see your own reflection! A black trim goes all around the sides, with blue tinted windows. Surprisingly there are no tires, and exhaust pipes stick out from the back of the car A fairly large bar code is inscribed on the trunk.

>e
Lab Room
It is very gloomy in here with its spherical lights. You can vaguely see equpiment that you have in your very own lab room as well. The desks and chairs are covered in cob webs. The lab shelves are high up with shiny objects on the top. The walls are completely white with faded designs on them.
The outback dump is to the south, pristine library is to the east, garage to the west, and aurora walk is to the north.

>e
The Pristine Library
The library is embedded with silver crystals all around the walls. There are shelves that contain thousands of historical books that date back to your time. A clear glass door is on the far side of the library along with a painting of a prestigious man.
The facial salon is to the north, and lab room is to the west.

>n
Facial Salon
A pretty beautician in the back of the counter is waiting to greet people as they walk through. The aroma of strawberry surrounds the salon. Lots of thin silk and hair is scattered all over the checker-board floor and tabletops. The fancy light blue lights gives the room a nice "cool" feeling to it. Silk seems to have been excreted from the tiny holes of the lights for some reason. White leather seats around the mirrors make up almost the entire salon.
The aurora walk is to the west, and pristine library to the south.

>e
You can't go that way.

>x seats
A white leather seat that has a circlular opening for you to lay your head on. A thin plastic triangular cutout is laying on one of the white leather seats.

* * *

>take cutout
Taken.

>take silk
Taken.

>w
Aurora Walk
This seems to be the main walkway for many people. It is busy and lots of rubbish is littered on the ground. A trash can is always available yet no one has the decency to throw the trash into it. The ground is made up of a thick green cushiony pad. Many of the pedestrians are walking by and minding their own buisiness.
The lab room is to the south, facial salon to the east, tech building to the west, and DNA beach to the north.

>n
DNA Beach
Surfs-up! Seems as though everyone's at the beach today. A sign shows the reports of the day. Many beach blankets cover the bed of sand. A red box lies underneath the analysis sign.
The aurora walk is to the south, sandy ocean to the north, and cruising shack to the east.

* * *

>e
Cruising Shack
An open cabin made out of wooden planks. A cashier runs the whole place, while people go in and out, grabbing beach gear from the automatic moving beach shelf. Looks like you can just borrow the gear instead of paying.
The DNA Beach is to the west.

Sunny is leaning on the counter inside the Shack waiting for someone to ask for assistance.

>cut plank with saw
Why would you cut that?

>i
You are carrying:
  Thin silk
  Triangular Cutout
  Saw
  an orange backpack (open but empty)
  White shirt
  Jeans
  Glasses
  Prototype watch

>take plank
Taken.

>cut plank with saw
Why would you cut that?

>cut plank with saw
Why would you cut that?

>use saw to cut plannk
That's not a verb I recognise.

>use saw to cut plank
That's not a verb I recognise.

>cut plank with saw
Why would you cut that?

>i
You are carrying:
  Wooden Plank
  Thin silk
  Triangular Cutout
  Saw
  an orange backpack (open but empty)
  White shirt
  Jeans
  Glasses
  Prototype watch

>cut plank
You successfully cut the wooden plank into an oval plank.

>i
You are carrying:
  Oval Plank
  Thin silk
  Triangular Cutout
  Saw
  an orange backpack (open but empty)
  White shirt
  Jeans
  Glasses
  Prototype watch

>examine self
You are a tall young man, about 6 foot 2 inches. You are wearing a plain white T-shirt, black slim jeans, white shoes, prescription glasses, your prototype watch, and the orange backpack.

>i
You are carrying:
  Oval Plank
  Thin silk
  Triangular Cutout
  Saw
  an orange backpack (open but empty)
  White shirt
  Jeans
  Glasses
  Prototype watch

* * *

>w
Thrift Shop
An old-school, yet reimaged look of a Thirft Shop. The racks of clothes and hangers automatically rotate once you are done looking at them. Most of the stuff here dates back to 2010. Looks fairly brand new and in style.
The tech building is to the east, and floating sidewalk to the south.

>w
You can't go that way.

* * *

>w
Lockdown
The prison cells are extremely small. The whole entire Lockdown contain chunks of the luminated steel that emerge from underneath the ground, and move guards toward each cell. The cell bars and walls are also made out of the same material as the floor. At least twenty guards are lined up around each corner of the jail. One of the guards
The floating sidewalk is to the east.

>x prison cell
Contains cell bars, walls, and bed for the prisoner. Not very luxurious but suitable for reprobates. 
There seems to be a pocket knife here too.

>take knife
Taken.

* * *

>e
Floating Sidewalk
A luminated clear pathway slowly elevates as you walk farther up onto it. Metal handbars line the edges of the clear floating path. It feels as if you're walking on a cloud, but looks like a beam of light!
The garage is to the east, the lockdown to the west, thrift shop to the north, and directional path to the south.

>n
Thrift Shop
An old-school, yet reimaged look of a Thirft Shop. The racks of clothes and hangers automatically rotate once you are done looking at them. Most of the stuff here dates back to 2010. Looks fairly brand new and in style.
The tech building is to the east, and floating sidewalk to the south.

>e
Tech Building
A Medium Sized robot is the only thing on the floor around the building. Programers are focused on their work on building more of these robots.
The garage is to the south, aurora walk to the east, and thrift shop to the west.

You can see Medium Sized Robot here.

* * *

>n
You can't go that way.

I beg your pardon?

* * *

>take plank
Taken.

>cut planbk
You can't see any such thing.

>cut plank
You successfully cut the wooden plank into an oval plank.

>cut plank
Cutting that up would achieve little.

>wooden
That's not a verb I recognise.

>i
You are carrying:
  Oval Plank
  Wooden Plank
  Pocket Knife
  an orange backpack (open but empty)
  White shirt
  Jeans
  Glasses
  Prototype watch

* * *

>e
Cruising Shack
An open cabin made out of wooden planks. A cashier runs the whole place, while people go in and out, grabbing beach gear from the automatic moving beach shelf. Looks like you can just borrow the gear instead of paying.
The DNA Beach is to the west.

Sunny is leaning on the counter inside the Shack waiting for someone to ask for assistance.

>x gear
Consists of swim suits, fins, and snorkels.

>take swim suit
Taken.

>put on suit
You will have to take of your shirt in order to put on the suit.

[Your score has just gone up by two points.]

>i
You are carrying:
  Swim Suit (being worn)
  an orange backpack (open but empty)
  Jeans
  Glasses
  Prototype watch

* * *

>x seats
A white leather seat that has a circlular opening for you to lay your head on. A thin plastic triangular cutout is laying on one of the white leather seats.

>x cutout
A plastic triangular figure that someone left on the seat. Maybe you can combine this with something else.

>take cutout
Taken.

>i
You are carrying:
  Triangular Cutout
  an orange backpack (open but empty)
  White shirt
  Jeans
  Glasses
  Prototype watch

>look
Facial Salon
A pretty beautician in the back of the counter is waiting to greet people as they walk through. The aroma of strawberry surrounds the salon. Lots of thin silk and hair is scattered all over the checker-board floor and tabletops. The fancy light blue lights gives the room a nice "cool" feeling to it. Silk seems to have been excreted from the tiny holes of the lights for some reason. White leather seats around the mirrors make up almost the entire salon.
The aurora walk is to the west, and pristine library to the south.

>x seats
A white leather seat that has a circlular opening for you to lay your head on.

>w
Aurora Walk
This seems to be the main walkway for many people. It is busy and lots of rubbish is littered on the ground. A trash can is always available yet no one has the decency to throw the trash into it. The ground is made up of a thick green cushiony pad. Many of the pedestrians are walking by and minding their own buisiness.
The lab room is to the south, facial salon to the east, tech building to the west, and DNA beach to the north.

>e
Facial Salon
A pretty beautician in the back of the counter is waiting to greet people as they walk through. The aroma of strawberry surrounds the salon. Lots of thin silk and hair is scattered all over the checker-board floor and tabletops. The fancy light blue lights gives the room a nice "cool" feeling to it. Silk seems to have been excreted from the tiny holes of the lights for some reason. White leather seats around the mirrors make up almost the entire salon.
The aurora walk is to the west, and pristine library to the south.

>take silk
Taken.

* * *

>w
Lockdown
The prison cells are extremely small. The whole entire Lockdown contain chunks of the luminated steel that emerge from underneath the ground, and move guards toward each cell. The cell bars and walls are also made out of the same material as the floor. At least twenty guards are lined up around each corner of the jail. One of the guards
The floating sidewalk is to the east.

>x prison
Contains cell bars, walls, and bed for the prisoner. Not very luxurious but suitable for reprobates. 
There seems to be a pocket knife here too.

>take knife
Taken.

* * *

>e
Cruising Shack
An open cabin made out of wooden planks. A cashier runs the whole place, while people go in and out, grabbing beach gear from the automatic moving beach shelf. Looks like you can just borrow the gear instead of paying.
The DNA Beach is to the west.

Sunny is leaning on the counter inside the Shack waiting for someone to ask for assistance.

>x planks
Beige colored strips of wood that are not too thick and not too thin.

>take plank
Taken.

>combine plank with cutout
I now have a Fragile Board!

>combine fragile board with silk
I can't combine Fragile Board and Thin silk and into anything useful.

>w
DNA Beach
Surfs-up! Seems as though everyone's at the beach today. A sign shows the reports of the day. Many beach blankets cover the bed of sand. A red box lies underneath the analysis sign.
The aurora walk is to the south, sandy ocean to the north, and cruising shack to the east.

* * *

>w
Lockdown
The prison cells are extremely small. The whole entire Lockdown contain chunks of the luminated steel that emerge from underneath the ground, and move guards toward each cell. The cell bars and walls are also made out of the same material as the floor. At least twenty guards are lined up around each corner of the jail. One of the guards
The floating sidewalk is to the east.

>x guard
You can't see any such thing.

>talk to lewis
"Hi, there," you say confidently.

"Do you have any questions?" he asks casually.

>talk to lewis
"Nice black outfit you got there," you comment. "Where did you get it?"

"It's fashionable, but I have to wear it since people recognize me as a watch guard. It's also Lucas" new law for this city too." Troy replies, looking down as his uniform. "Who is this Lucas person that you speak of?"

>say hi
(to Lewis)
There is no reply.

>talk
(to Lewis)
"Who is Lucas?" you say sternly. 

Troy laughs heartily. "You don't know who Lucas is? You're so silly, you've probably seen his picture somewhere around. He is the mayor of this city."

>really?
That's not a verb I recognise.

>say really
(to Lewis)
There is no reply.

>talk
(to Lewis)
Are you serious?! Lucas is our mayor… How do you not know this?饟땐ע뒰ע

40 minutes passed already. Wow! You haven't been checking your time lately.

>talk
(to Lewis)
Are you serious?! Lucas is our mayor… How do you not know this?湵!瀀힜⁞渎摯ⵥ砰〵慢捡0/躰ײ

>talk
(to Lewis)
Are you serious?! Lucas is our mayor… How do you not know this?ת

>e
Floating Sidewalk
A luminated clear pathway slowly elevates as you walk farther up onto it. Metal handbars line the edges of the clear floating path. It feels as if you're walking on a cloud, but looks like a beam of light!
The garage is to the east, the lockdown to the west, thrift shop to the north, and directional path to the south.

* * *

>x bag
A brown bag made out of soft silk. The designs on the bag is of a face of an old man with grey hair and glasses.

>take bag
Taken.

>open bag
You open the bag, revealing Pepto Bismol and Pin.

>take pepto bismol
This looks like you can give it to someone to treat their sickness.

>i
You are carrying:
  a bag (open)
    Pepto Bismol
    Pin
  Fragile Board
  Pocket Knife
  Thin silk
  an orange backpack (open but empty)
  White shirt
  Jeans
  Glasses
  Prototype watch

>drink pepto bismol
It tastes like a mint candy, but doesn't settle too well in your stomach.

No worries, 50 minutes passed. About 40 minutes to go.

>health
That's not a verb I recognise.

>x health
You can't see any such thing.

* * *

>n
Aurora Walk
This seems to be the main walkway for many people. It is busy and lots of rubbish is littered on the ground. A trash can is always available yet no one has the decency to throw the trash into it. The ground is made up of a thick green cushiony pad. Many of the pedestrians are walking by and minding their own buisiness.
The lab room is to the south, facial salon to the east, tech building to the west, and DNA beach to the north.

>s
Lab Room
It is very gloomy in here with its spherical lights. You can vaguely see equpiment that you have in your very own lab room as well. The desks are covered in cob webs. The lab shelves are high up with shiny objects on the top. The walls are completely white with faded designs on them.
The outback dump is to the south, pristine library is to the east, garage to the west, and aurora walk is to the north.

>x equipment
A Volumetric Flask, beaker, work gloves, and a goggle make up the equipment.

>x desks
Clear glass desks that stands on two sturdy legs. Different glass containers are labeled: Nitrate, Sulfate, and Astatine. Maybe you can mix the chemicals as a mini experiment.

>mix nitrate with sulfate
You created Chemical X!

>combine nitrate with sulfate
You can't see any such thing.

>i
You are carrying:
  Chemical X
  an orange backpack (open but empty)
  White shirt (being worn)
  Jeans (being worn)
  Glasses (being worn)
  White shoes (being worn)
  Prototype watch (being worn)

>n
Aurora Walk
This seems to be the main walkway for many people. It is busy and lots of rubbish is littered on the ground. A trash can is always available yet no one has the decency to throw the trash into it. The ground is made up of a thick green cushiony pad. Many of the pedestrians are walking by and minding their own buisiness.
The lab room is to the south, facial salon to the east, tech building to the west, and DNA beach to the north.

>e
Facial Salon
There is an aroma of strawberry that surrounds the salon. Lots of thin silk and hair is scattered all over the checker-board floor and tabletops. The fancy light blue lights gives the room a nice "cool" feeling to it. Silk seems to have been excreted from the tiny holes of the lights for some reason. White leather seats around the mirrors make up almost the entire salon.
The aurora walk is to the west, and pristine library to the south.

>n
You can't go that way.

>w
Aurora Walk
This seems to be the main walkway for many people. It is busy and lots of rubbish is littered on the ground. A trash can is always available yet no one has the decency to throw the trash into it. The ground is made up of a thick green cushiony pad. Many of the pedestrians are walking by and minding their own buisiness.
The lab room is to the south, facial salon to the east, tech building to the west, and DNA beach to the north.

* * *

>x gear
Consists of swim suits, fins, and snorkels.

>put on swim suit
(first taking Swim Suit)
You will have to take of your shirt in order to put on the suit.

[Your score has just gone up by two points.]

>i
You are carrying:
  Swim Suit (being worn)
  Chemical X
  an orange backpack (open but empty)
  Jeans (being worn)
  Glasses (being worn)
  White shoes (being worn)
  Prototype watch (being worn)

* * *

>e
The Pristine Library
The library is embedded with silver crystals all around the walls. There are shelves that contain thousands of historical books that date back to your time. A clear glass door is on the far side of the library along with a painting of a prestigious man.
The facial salon is to the north, and lab room is to the west.

>xshelves
That's not a verb I recognise.

>x shelves
Glass shelves that hold many books arranged in alphabetical order. There is one black book that seems to be jutting out a little too far than the others.

* * *

>e
Mysterious Room
A hidden room lighted with lit candles instead of bright light bulbs. Stacks of golden bricks fill the entire room. Another pile of raw silk is in the side corner. Must be a secret stash hidden by someone.
The pristine library is to the west.

>x silk
Very curly white silk.

>take silk
You take a handful of the silk. It is so soft and smooth, almost as if you're grabbing air!

>i
You are carrying:
  Raw Silk
  Black Book
  an orange backpack (open but empty)
  White shirt
  Jeans
  Glasses
  Prototype watch

>take golden brick
I only understood you as far as wanting to take Golden Bricks.

>take golden brick
I only understood you as far as wanting to take Golden Bricks.

* * *

>i
You are carrying:
  Golden Brick
  Raw Silk
  Black Book
  an orange backpack (open but empty)
  White shirt
  Jeans
  Glasses
  Prototype watch

>look
Mysterious Room
A hidden room lighted with lit candles instead of bright light bulbs. Stacks of golden bricks fill the entire room.  Must be a secret stash hidden by someone.
The pristine library is to the west.

* * *

>x shelves
Glass shelves that hold many books arranged in alphabetical order. There is one black book that seems to be jutting out a little too far than the others.

>shelf
That's not a verb I recognise.

>x shelf
You can't see any such thing.

>x crystals
Shiny and smooth crystals that gives the library an amazing glow.

* * *

>take crystals
[Your score has just gone up by five points.]

>put crystal into backpack
You can't see any such thing.

>put crystals into backpack
You put Silver Crystals into the orange backpack.

>i
You are carrying:
  an orange backpack (open)
    Silver Crystals
  White shirt
  Jeans
  Glasses
  Prototype watch

>x bookshelves
Glass shelves that hold many books arranged in alphabetical order. There is one black book that seems to be jutting out a little too far than the others.

* * *

>e
The Pristine Library
The library is embedded with silver crystals all around the walls. There are shelves that contain thousands of historical books that date back to your time. A clear glass door is on the far side of the library along with a painting of a prestigious man.
The facial salon is to the north, and lab room is to the west.

>x shelf
You can't see any such thing.

>x shelves
Glass shelves that hold many books arranged in alphabetical order. There is one black book that seems to be jutting out a little too far than the others.

>take book
You found a hidden lever!

Taken.

>pull lever
You found a hidden door to the east! Wonder where that leads to.

[Your score has just gone up by one hundred and fifty points.]

* * *

>e
Mysterious Room
A hidden room lighted with lit candles instead of bright light bulbs. Stacks of golden bricks fill the entire room. Another pile of raw silk is in the side corner. Must be a secret stash hidden by someone.
The pristine library is to the west.

>take golden brick
[Your score has just gone up by five points.]

>put golden brick into backpack
You put Golden Brick into the orange backpack.

>i
You are carrying:
  Black Book
  an orange backpack (open)
    Golden Brick
  White shirt
  Jeans
  Glasses
  Prototype watch

>open backpack
That's already open.

>e
You can't go that way.

>w
The Pristine Library
The library is embedded with silver crystals all around the walls. There are shelves that contain thousands of historical books that date back to your time. A clear glass door is on the far side of the library along with a painting of a prestigious man.
The facial salon is to the north, and lab room is to the west.

* * *

>w
Lab Room
It is very gloomy in here with its spherical lights. You can vaguely see equpiment that you have in your very own lab room as well. The desks and chairs are covered in cob webs. The lab shelves are high up with shiny objects on the top. The walls are completely white with faded designs on them.
The outback dump is to the south, pristine library is to the east, garage to the west, and aurora walk is to the north.

>n
Aurora Walk
This seems to be the main walkway for many people. It is busy and lots of rubbish is littered on the ground. A trash can is always available yet no one has the decency to throw the trash into it. The ground is made up of a thick green cushiony pad. Many of the pedestrians are walking by and minding their own buisiness.
The lab room is to the south, facial salon to the east, tech building to the west, and DNA beach to the north.

* * *

>e
Facial Salon
A pretty beautician in the back of the counter is waiting to greet people as they walk through. The aroma of strawberry surrounds the salon. Lots of thin silk and hair is scattered all over the checker-board floor and tabletops. The fancy light blue lights gives the room a nice "cool" feeling to it. Silk seems to have been excreted from the tiny holes of the lights for some reason. White leather seats around the mirrors make up almost the entire salon.
The aurora walk is to the west, and pristine library to the south.

>e
You can't go that way.

>x seasts
You can't see any such thing.

>x seats
A white leather seat that has a circlular opening for you to lay your head on. A thin plastic triangular cutout is laying on one of the white leather seats.

* * *

>take cutout
Taken.

>look
Facial Salon
A pretty beautician in the back of the counter is waiting to greet people as they walk through. The aroma of strawberry surrounds the salon. Lots of thin silk and hair is scattered all over the checker-board floor and tabletops. The fancy light blue lights gives the room a nice "cool" feeling to it. Silk seems to have been excreted from the tiny holes of the lights for some reason. White leather seats around the mirrors make up almost the entire salon.
The aurora walk is to the west, and pristine library to the south.

* * *

>s
Floating Sidewalk
A luminated clear pathway slowly elevates as you walk farther up onto it. Metal handbars line the edges of the clear floating path. It feels as if you're walking on a cloud, but looks like a beam of light!
The garage is to the east, the lockdown to the west, thrift shop to the north, and directional path to the south.

>w
Lockdown
The prison cells are extremely small. The whole entire Lockdown contain chunks of the luminated steel that emerge from underneath the ground, and move guards toward each cell. The cell bars and walls are also made out of the same material as the floor. At least twenty guards are lined up around each corner of the jail.
The floating sidewalk is to the east.

>x prison cell
Contains cell bars, walls, and bed for the prisoner. Not very luxurious but suitable for reprobates. 
There seems to be a pocket knife here too.

* * *

>e
Aurora Walk
This seems to be the main walkway for many people. It is busy and lots of rubbish is littered on the ground. A trash can is always available yet no one has the decency to throw the trash into it. The ground is made up of a thick green cushiony pad. Many of the pedestrians are walking by and minding their own buisiness.
The lab room is to the south, facial salon to the east, tech building to the west, and DNA beach to the north.

>e
Facial Salon
A pretty beautician in the back of the counter is waiting to greet people as they walk through. The aroma of strawberry surrounds the salon. Lots of thin silk and hair is scattered all over the checker-board floor and tabletops. The fancy light blue lights gives the room a nice "cool" feeling to it. Silk seems to have been excreted from the tiny holes of the lights for some reason. White leather seats around the mirrors make up almost the entire salon.
The aurora walk is to the west, and pristine library to the south.

>w
Aurora Walk
This seems to be the main walkway for many people. It is busy and lots of rubbish is littered on the ground. A trash can is always available yet no one has the decency to throw the trash into it. The ground is made up of a thick green cushiony pad. Many of the pedestrians are walking by and minding their own buisiness.
The lab room is to the south, facial salon to the east, tech building to the west, and DNA beach to the north.

* * *

>e
Cruising Shack
An open cabin made out of wooden planks. A cashier runs the whole place, while people go in and out, grabbing beach gear from the automatic moving beach shelf. Looks like you can just borrow the gear instead of paying.
The DNA Beach is to the west.

Sunny is leaning on the counter inside the Shack waiting for someone to ask for assistance.

>take wooden planks
Don't be greedy, you only need one wooden plank strip. Save some for everyone else.

>i
You are carrying:
  Wooden Plank
  Pocket Knife
  Triangular Cutout
  Black Book
  an orange backpack (open)
    Golden Brick
  White shirt
  Jeans
  Glasses
  Prototype watch

>w
DNA Beach
Surfs-up! Seems as though everyone's at the beach today. A sign shows the reports of the day. Many beach blankets cover the bed of sand. A red box lies underneath the analysis sign.
The aurora walk is to the south, sandy ocean to the north, and cruising shack to the east.

>s
Aurora Walk
This seems to be the main walkway for many people. It is busy and lots of rubbish is littered on the ground. A trash can is always available yet no one has the decency to throw the trash into it. The ground is made up of a thick green cushiony pad. Many of the pedestrians are walking by and minding their own buisiness.
The lab room is to the south, facial salon to the east, tech building to the west, and DNA beach to the north.

>e
Facial Salon
A pretty beautician in the back of the counter is waiting to greet people as they walk through. The aroma of strawberry surrounds the salon. Lots of thin silk and hair is scattered all over the checker-board floor and tabletops. The fancy light blue lights gives the room a nice "cool" feeling to it. Silk seems to have been excreted from the tiny holes of the lights for some reason. White leather seats around the mirrors make up almost the entire salon.
The aurora walk is to the west, and pristine library to the south.

40 minutes passed already. Wow! You haven't been checking your time lately.

>drop black book
Dropped.

>take silk
Taken.

* * *

>w
Aurora Walk
This seems to be the main walkway for many people. It is busy and lots of rubbish is littered on the ground. A trash can is always available yet no one has the decency to throw the trash into it. The ground is made up of a thick green cushiony pad. Many of the pedestrians are walking by and minding their own buisiness.
The lab room is to the south, facial salon to the east, tech building to the west, and DNA beach to the north.

I beg your pardon?

>n
DNA Beach
Surfs-up! Seems as though everyone's at the beach today. A sign shows the reports of the day. Many beach blankets cover the bed of sand. A red box lies underneath the analysis sign.
The aurora walk is to the south, sandy ocean to the north, and cruising shack to the east.

* * *

>e
Cruising Shack
An open cabin made out of wooden planks. A cashier runs the whole place, while people go in and out, grabbing beach gear from the automatic moving beach shelf. Looks like you can just borrow the gear instead of paying.
The DNA Beach is to the west.

Sunny is leaning on the counter inside the Shack waiting for someone to ask for assistance.

>combine woodne plank and silk
You can't see any such thing.

>combine wooden plank and cutout
You can't use multiple objects with that verb.

>combine plank and silk
You can't use multiple objects with that verb.

>combine plank with silk
I can't combine Wooden Plank and Thin silk and into anything useful.

>combine plank with cutout
I now have a Fragile Board!

* * *

>combine fragile board with silk
I can't combine Fragile Board and Thin silk and into anything useful.

>combine board with silk
I can't combine Fragile Board and Thin silk and into anything useful.

>combine silk with board
I can't combine Thin silk and Fragile Board and into anything useful.

No worries, 50 minutes passed. About 40 minutes to go.

>cut board
Cutting that up would achieve little.

* * *

>x equipment
A Volumetric Flask, beaker, work gloves, and a goggle make up the equipment.