You are an intelligent scientist who has invented a prototype watch that allows you to travel 40 years into the future. You have exactly an hour and a half in the future day before your watch teleports you back home. In the mean time, you can do anything your heart desires, but use your time wisely!

You have successfully teleported into the future. Keep an eye on your watch at all times.

"Whoa!!!" you say. "I guess this is what my laboratory will look like 40 years from now… How magnificent!"

Into The Future
An Interactive Fiction by Tyler Makabe
Release 1 / Serial number 130305 / Inform 7 build 6G60 (I6/v6.32 lib 6/12N) SD

Lab Room
It is very gloomy in here with its spherical lights. You can vaguely see equpiment that you have in your very own lab room as well. The desks and chairs are covered in cob webs, with different flasks that contain unique chemicals inside them. The lab shelves are high up with shiny objects on the top. The walls are completely white with faded designs on them. An orange container is in here as well so that you can put all your findings into here and take them back home with you.

>west
garage
This must be your garage. You notice all of your very own tools hanging from the walls. A fabulous car is parked in the middle of it. What an upgrade indeed!

Such an incredible piece of work! The car is slick and skinny. A white coat of paint is layered on the whole car and you can even see your own reflection! A black trim goes all around the sides, with blue tinted windows. Surprisingly there are no tires, and exhaust pipes stick out from the back of the car A fairly large bar code is inscribed on the trunk.

>ride XD4
That's not a verb I recognise.

>drie
That's not a verb I recognise.

>drive
That's not a verb I recognise.

* * *

>west
garage
This must be your garage. You notice all of your very own tools hanging from the walls. A fabulous car is parked in the middle of it. What an upgrade indeed!

Such an incredible piece of work! The car is slick and skinny. A white coat of paint is layered on the whole car and you can even see your own reflection! A black trim goes all around the sides, with blue tinted windows. Surprisingly there are no tires, and exhaust pipes stick out from the back of the car A fairly large bar code is inscribed on the trunk.

>ride car
The car cannot be ridden.

>drive car
That's not a verb I recognise.

* * *

>take all
Hey stop that! All is disabled.

* * *

>ride dog
You mount Dog.

* * *

>x equpiment
You can't see any such thing.

>x equipment
You see nothing special about Equipment.

>x equipment
You see nothing special about Equipment.

* * *

>x equipment
Volumetric Flasks, beakers, work gloves, and goggles make up the equipment.

>x lights
You see nothing special about the lights.

>xlight
That's not a verb I recognise.

>x light
You can't see any such thing.

* * *

>x equipment
Volumetric Flasks, beakers, work gloves, and goggles make up the equipment.

>x volumetric flasks
Used to mix different chemicals in, and create experiments.

>take flasks
Taken.

* * *

>x lights
You see nothing special about the lights.

* * *

>x light
You can't see any such thing.

>x the lights
You see nothing special about the lights.

* * *

>east
Pristine Library
The library is embedded with silver crystals all around the walls. There are about ten different shelves that contain thousands of historic books that date back to your time. One of them is a black book that seems to be jutting out a little too far than the others though. A clear glass door is on the far side of the library along with a painting of a prestigious man.

>x silver crystal
I only understood you as far as wanting to examine the Silver Crystals.

>take crystal
You can't see any such thing.

>take silver crystal
I only understood you as far as wanting to take the Silver Crystals.

>take silver crystals
Taken.

>x painting
The old man in the painting looks formally dressed in a black suit and red tie. Is he supposed to be important or something?

>take painting
That's hardly portable.

>x door
You see nothing special about the glass door.

>x glass door
You see nothing special about the glass door.

* * *

>east
Pristine Library
The library is embedded with silver crystals all around the walls. There are about ten different shelves that contain thousands of historic books that date back to your time. One of them is a black book that seems to be jutting out a little too far than the others though. A clear glass door is on the far side of the library along with a painting of a prestigious man.

>x door
An extremely clear door that automatically opens when it senses your movement.

* * *

>east
Pristine Library
The library is embedded with silver crystals all around the walls. There are about ten different shelves that contain thousands of historic books that date back to your time. One of them is a black book that seems to be jutting out a little too far than the others though. A clear glass door is on the far side of the library along with a painting of a prestigious man.

>north
Fresh Barber Shop
s

>east
You can't go that way.

>west
Aurora Walk
s

>west
Tech Building
s

>weset
That's not a verb I recognise.

>west
Old Thirft Shop
s

>south
Floating Sidewalk
s

>west
Lockdown
s

>east
Floating Sidewalk
s

>south
Pathway
s

>south
Elevator Shaft
s

>east
Obscure Parking Lot
s

>east
Skyscraper
s

>east
Plaza
s

>west
Skyscraper
s

>north
Stairway
s

You realize that you have only fifteen more minutes to get the cat into his carrier.

>north
View
s

>south
Stairway
s

>south
Skyscraper
s

>south
Alternative
s

* * *

>east
Pristine Library
The library is embedded with silver crystals all around the walls. There are about ten different shelves that contain thousands of historic books that date back to your time. One of them is a black book that seems to be jutting out a little too far than the others though. A clear glass door is on the far side of the library along with a painting of a prestigious man.

>west
Lab
s

>north
Aurora Walk
s

>west
Tech Building
s

>west
Old Thirft Shop
s

* * *

>south
Floating Sidewalk
s

>east
Garage
s

s

>west
Floating Sidewalk
s

>west
You can't go that way.

* * *

>east
Pristine Library
The library is embedded with silver crystals all around the walls. There are about ten different shelves that contain thousands of historic books that date back to your time. One of them is a black book that seems to be jutting out a little too far than the others though. A clear glass door is on the far side of the library along with a painting of a prestigious man.

>east
You can't go that way.

>west
Lab Room
It is very gloomy in here with its spherical lights. You can vaguely see equpiment that you have in your very own lab room as well. The desks and chairs are covered in cob webs, with different flasks that contain unique chemicals inside them. The lab shelves are high up with shiny objects on the top. The walls are completely white with faded designs on them. An orange container is in here as well so that you can put all your findings into here and take them back home with you.

>north
Aurora Walk
This seems to be the main walkway for many people. It is busy and lots of trash is littered on the ground. The ground is made up of a thick green cushiony pad.

>south
Lab Room
It is very gloomy. The spherical lights are dark blue. You can vaguely see equpiment that you have in your very own lab room. The desks and chairs are covered in cob webs, with different flasks that contain unique chemicals inside them. The shelves are high up with shiny objects on the top. Other than that, there is nothing so futuristic about this room.

>south
Outback Dump
A room made specially for trash and filthy chemicals. It reeks of carbon and a large dumpster is in the center of the room. A bunch of dead spiders are scattered all over the place. Disgusting.

>north
Lab Room
It is very gloomy. The spherical lights are dark blue. You can vaguely see equpiment that you have in your very own lab room. The desks and chairs are covered in cob webs, with different flasks that contain unique chemicals inside them. The shelves are high up with shiny objects on the top. Other than that, there is nothing so futuristic about this room.

>west
Garage
This must be your garage. You notice all of your very own tools hanging from the walls. A fabulous car is parked in the middle of it. What an upgrade indeed!

Such an incredible piece of work! The car is slick and skinny. A white coat of paint is layered on the whole car and you can even see your own reflection! A black trim goes all around the sides, with blue tinted windows. Surprisingly there are no tires, and exhaust pipes stick out from the back of the car A fairly large bar code is inscribed on the trunk.

>west
Floating Sidewalk
A luminated clear pathway slowly elevates as you walk farther up onto it. Metal handbars line the edges of the clear floating path. It feels as if you're walking on a cloud, but looks like a beam of light!

>weset
That's not a verb I recognise.

>west
Lockdown
The jail is extremely large. Chunks of the luminated ground emerge from underneath and move toward each cell. The cell bars and walls are too made out of the same material as the floor. At least twenty guards are lined up around each corner of the jail.

>north
You can't go that way.

>south
You can't go that way.

>west
You can't go that way.

>east
Floating Sidewalk
A luminated clear pathway slowly elevates as you walk farther up onto it. Metal handbars line the edges of the clear floating path. It feels as if you're walking on a cloud, but looks like a beam of light!

>north
Old Thirft Shop
An old-school yet reimaged look of a Thirft Shop. The racks of clothes and hangers automatically rotate once you are done looking at them. Most of the stuff here dates back to 2010. Looks fairly brand new and in style.

>west
You can't go that way.

You realize that you have only fifteen more minutes to get the cat into his carrier.

>east
Tech Building
Miniature sized robots cover the floor around the building. Programers focused on their work on building more of these tiny robots.

>east
Aurora Walk
This seems to be the main walkway for many people. It is busy and lots of trash is littered on the ground. The ground is made up of a thick green cushiony pad.

>east
Facial Salon
A pretty beautician in the back of the counter is waiting to greet people as they walk through. The aroma of strawberry surrounds the salon. Lots of silk and hair is scattered all over the checker-board floor and tabletops. Black leather seats around the mirrors make up almost the entire salon.

>east
You can't go that way.

>east
You can't go that way.

>south
Pristine Library
The library is embedded with silver crystals all around the walls. There are about ten different shelves that contain thousands of historic books that date back to my time. A clear glass door is on the far side of the library.

>west
Lab Room
It is very gloomy. The spherical lights are dark blue. You can vaguely see equpiment that you have in your very own lab room. The desks and chairs are covered in cob webs, with different flasks that contain unique chemicals inside them. The shelves are high up with shiny objects on the top. Other than that, there is nothing so futuristic about this room.

>west
Garage
This must be your garage. You notice all of your very own tools hanging from the walls. A fabulous car is parked in the middle of it. What an upgrade indeed!

Such an incredible piece of work! The car is slick and skinny. A white coat of paint is layered on the whole car and you can even see your own reflection! A black trim goes all around the sides, with blue tinted windows. Surprisingly there are no tires, and exhaust pipes stick out from the back of the car A fairly large bar code is inscribed on the trunk.  

Your exhaustion is threatening to send you crashing to the floor, unable to move.

>south
Obscure Parking Lot
An eighteen foot parking structure that allows you to park your car whenever you want.

>south
You can't go that way.

>west
Elevator Shaft
Watch out! Yellow tape borders the edges of the elevator. Seems as though the elevator is out of function.

>east
Obscure Parking Lot
An eighteen foot parking structure that allows you to park your car whenever you want.

>east
Skyscraper 057
The largest building in the vicinity. Two steel doors open and close as you enter. The Skyscraper is filled with many people trying to buy and sell their products amongst many business owners.  Low square desks and pillows make up the whole floor. A young little girl is huddled in the corner as tears rush down her face. Where are her parents? How strange.

>east
Plaza Streets
People hustle and bustle around the plaza. A large fish fountain with a statue of a person is located in the center of it. The ground is tiled with black and blue cement around the plaza. What a sight.

>east
You can't go that way.

You are about to drop dead of exhaustion. "The cats will be the death of me," you always said.

>north
Epicenter
It smells very musty in here. Seems as though many homeless stay here for shelter and food. Many old blankets and reusable bags cover the entire room. You can see tiny insects crawling in and out of the bags. Surprisingly, the infrastructure looks amazing! The entire building has built-in LED lights inside the clear glass walls that flicker when you touch it.

>south
Plaza Streets
People hustle and bustle around the plaza. A large fish fountain with a statue of a person is located in the center of it. The ground is tiled with black and blue cement around the plaza. What a sight.

>south
Pear Incorporation
This is surprising to see that Apple has a rival in their industry. Hundreds of devices are scattered on the wooden desks around the room. The Pear Inc. workers are ready to assist anyone that needs help.

You stumble to your knees and then collapse on the floor, quite surprised to find that the phrase "drop dead of exhaustion" can be literally true.

>north
Plaza Streets
People hustle and bustle around the plaza. A large fish fountain with a statue of a person is located in the center of it. The ground is tiled with black and blue cement around the plaza. What a sight.

>west
Skyscraper 057
The largest building in the vicinity. Two steel doors open and close as you enter. The Skyscraper is filled with many people trying to buy and sell their products amongst many business owners.  Low square desks and pillows make up the whole floor. A young little girl is huddled in the corner as tears rush down her face. Where are her parents? How strange.

>south
Medical Field
This place is definately much more advanced than your old lab. The chemists are busy with their work. Seems as though a lot of the new technology is built here. Try and ask the chemists what they're creating now.

>south
You can't go that way.

>north
Skyscraper 057
The largest building in the vicinity. Two steel doors open and close as you enter. The Skyscraper is filled with many people trying to buy and sell their products amongst many business owners.  Low square desks and pillows make up the whole floor. A young little girl is huddled in the corner as tears rush down her face. Where are her parents? How strange.

>north
Stairway
Just an empty stairway. Wonder where this leads to.

>north
Skyscraper View
What an amazing sight to see. Long metal poles stretch across the edges of the skyscraper for safety. There's a nice breeze at the top of the Skyscraper. You can see almost everything from here, how fantastic. Just don't look down.

* * *

>west
Lab Room
It is very gloomy in here with its spherical lights. You can vaguely see equpiment that you have in your very own lab room as well. The desks and chairs are covered in cob webs, with different flasks that contain unique chemicals inside them. The lab shelves are high up with shiny objects on the top. The walls are completely white with faded designs on them. An orange container is in here as well so that you can put all your findings into here and take them back home with you.

>south
Outback Dump
A room made specially for trash and filthy chemicals. It reeks of carbon and a large dumpster is in the center of the room. A bunch of dead spiders are scattered all over the place. Disgusting.

* * *

>north
Lab Room
It is very gloomy in here with its spherical lights. You can vaguely see equpiment that you have in your very own lab room as well. The desks and chairs are covered in cob webs, with different flasks that contain unique chemicals inside them. The lab shelves are high up with shiny objects on the top. The walls are completely white with faded designs on them. An orange container is in here as well so that you can put all your findings into here and take them back home with you.

>north
Aurora Walk
This seems to be the main walkway for many people. It is busy and lots of trash is littered on the ground. The ground is made up of a thick green cushiony pad.

* * *

>west
Tech Building
Miniature sized robots cover the floor around the building. Programers focused on their work on building more of these tiny robots.

>west
Old Thirft Shop
An old-school yet reimaged look of a Thirft Shop. The racks of clothes and hangers automatically rotate once you are done looking at them. Most of the stuff here dates back to 2010. Looks fairly brand new and in style.

>west
You can't go that way.

>south
Floating Sidewalk
A luminated clear pathway slowly elevates as you walk farther up onto it. Metal handbars line the edges of the clear floating path. It feels as if you're walking on a cloud, but looks like a beam of light!

* * *

>east
Garage
This must be someone's garage. Definately not yours, that's for sure. Many intricate tools and devices hang from the walls and racks. A marvelous car is parked in the middle of it!

Such an incredible piece of work! The car is slick and skinny. A white coat of paint is layered on the whole car and you can even see your own reflection! A black trim goes all around the sides, with blue tinted windows. Surprisingly there are no tires, and exhaust pipes stick out from the back of the car A fairly large bar code is inscribed on the trunk.

>est
That's not a verb I recognise.

>west
Floating Sidewalk
A luminated clear pathway slowly elevates as you walk farther up onto it. Metal handbars line the edges of the clear floating path. It feels as if you're walking on a cloud, but looks like a beam of light!

>south
Directional Path
You are now on cement again. The texture of this pathway is much different from the Floating Sidewalk.

>south
Elevator Shaft
Watch out! Yellow tape borders the edges of the elevator. Seems as though the elevator is out of function.

>wets
That's not a verb I recognise.

>west
You can't go that way.

>east
Obscure Parking Lot
An eighteen foot parking structure that allows you to park your car whenever you want.

You realize that you have only fifteen more minutes to get the cat into his carrier.

>east
Skyscraper 057
The largest building in the vicinity. Two steel doors open and close as you enter. The Skyscraper is filled with many people trying to buy and sell their products amongst many business owners.  Low square desks and pillows make up the whole floor. A young little girl is huddled in the corner as tears rush down her face. Where are her parents? How strange.

* * *

>east
Plaza Streets
People hustle and bustle around the plaza. A large fish fountain with a statue of a person is located in the center of it. The ground is tiled with black and blue cement around the plaza. What a sight.

>nort
That's not a verb I recognise.

>north
Epicenter
It smells very musty in here. Seems as though many homeless stay here for shelter and food. Many old blankets and reusable bags cover the entire room. You can see tiny insects crawling in and out of the bags. Surprisingly, the infrastructure looks amazing! The entire building has built-in LED lights inside the clear glass walls that flicker when you touch it.

>north
You can't go that way.

>south
Plaza Streets
People hustle and bustle around the plaza. A large fish fountain with a statue of a person is located in the center of it. The ground is tiled with black and blue cement around the plaza. What a sight.

>souht
That's not a verb I recognise.

>south
Pear Incorporation
This is surprising to see that Apple has a rival in their industry. Hundreds of devices are scattered on the wooden desks around the room. The Pear Inc. workers are ready to assist anyone that needs help.

>north
Plaza Streets
People hustle and bustle around the plaza. A large fish fountain with a statue of a person is located in the center of it. The ground is tiled with black and blue cement around the plaza. What a sight.

>west
Skyscraper 057
The largest building in the vicinity. Two steel doors open and close as you enter. The Skyscraper is filled with many people trying to buy and sell their products amongst many business owners.  Low square desks and pillows make up the whole floor. A young little girl is huddled in the corner as tears rush down her face. Where are her parents? How strange. 

Your exhaustion is threatening to send you crashing to the floor, unable to move.

>south
Medical Field
This place is definately much more advanced than your old lab. The chemists are busy with their work. Seems as though a lot of the new technology is built here. Try and ask the chemists what they're creating now.