You are an intelligent scientist who has invented a prototype watch that allows you to travel 40 years into the future. You have exactly an hour and a half in the future day before your watch teleports you back home. In the mean time, you can do anything your heart desires, but use your time wisely!

You have successfully teleported into the future. Keep an eye on your watch at all times.

"Whoa!!!" you say. "I guess this is what my laboratory will look like 40 years from now… How magnificent!" 
Make sure you remember to put significnt items inside your backpack to bring back with you later on.

Into The Future
An Interactive Fiction by Tyler Makabe
Release 1 / Serial number 130315 / Inform 7 build 6G60 (I6/v6.32 lib 6/12N) SD

Lab Room
It is very gloomy in here with its spherical lights. You can vaguely see equpiment that you have in your very own lab room as well. The desks and chairs are covered in cob webs. The lab shelves are high up with shiny objects on the top. The walls are completely white with faded designs on them.
The outback dump is to the south, pristine library is to the east, garage to the west, and aurora walk is to the north.

>e
The Pristine Library
The library is embedded with silver crystals all around the walls. There are shelves that contain thousands of historical books that date back to your time. A clear glass door is on the far side of the library along with a painting of a prestigious man.
The facial salon is to the north, and lab room is to the west.

>x shelves
Glass shelves that hold many books arranged in alphabetical order. There is one black book that seems to be jutting out a little too far than the others.

>take black book
You found a hidden lever!

Taken.

>undo
The Pristine Library
[Previous turn undone.]

>pull black book
You found a hidden lever!

Nothing obvious happens.

>x lever
You see nothing special about the lever.

>pull lever
You found a hidden door to the east! Wonder where that leads to.

[Your score has just gone up by one hundred and fifty points.]

>e
Mysterious Room
A hidden room lighted with lit candles instead of bright light bulbs. Another pile of raw silk is in the side corner.Must be a secret stash hidden by someone.

>w
The Pristine Library
The library is embedded with silver crystals all around the walls. There are shelves that contain thousands of historical books that date back to your time. A clear glass door is on the far side of the library along with a painting of a prestigious man.
The facial salon is to the north, and lab room is to the west.

>x historical book
I only understood you as far as wanting to examine Historical Books.

>x books
Some of these books are brand new in your day and age. I guess they're historical treasures to the future now.

>take books
Taken.

>n
Facial Salon
A pretty beautician in the back of the counter is waiting to greet people as they walk through. The aroma of strawberry surrounds the salon. Lots of thin silk and hair is scattered all over the checker-board floor and tabletops. The fancy light blue lights gives the room a nice "cool" feeling to it. Silk seems to have been excreted from the tiny holes of the lights for some reason. White leather seats around the mirrors make up almost the entire salon.

>s
The Pristine Library
The library is embedded with silver crystals all around the walls. There are shelves that contain thousands of historical books that date back to your time. A clear glass door is on the far side of the library along with a painting of a prestigious man.
The facial salon is to the north, and lab room is to the west.

>e
Mysterious Room
A hidden room lighted with lit candles instead of bright light bulbs. Another pile of raw silk is in the side corner.Must be a secret stash hidden by someone.

>x raw silk
Very curly white silk.

>take raw silk
You take a handful of the silk. It is so soft and smooth, almost as if you're grabbing air!

>look
Mysterious Room
A hidden room lighted with lit candles instead of bright light bulbs. Must be a secret stash hidden by someone.

>take golden bricks
Unfortunately, you are only strong enough to hold one of the bars.

>i
You are carrying:
  Golden Brick
  Raw Silk
  Historical Books
  White shirt
  Jeans
  Glasses
  Prototype watch
  an orange backpack (open but empty)

>look
Mysterious Room
A hidden room lighted with lit candles instead of bright light bulbs. Must be a secret stash hidden by someone.

>drop silk
Dropped.

>look
Mysterious Room
A hidden room lighted with lit candles instead of bright light bulbs. Another pile of raw silk is in the side corner.Must be a secret stash hidden by someone.

You can see Raw Silk here.

>w
The Pristine Library
The library is embedded with silver crystals all around the walls. There are shelves that contain thousands of historical books that date back to your time. A clear glass door is on the far side of the library along with a painting of a prestigious man.
The facial salon is to the north, and lab room is to the west.

>e
Mysterious Room
A hidden room lighted with lit candles instead of bright light bulbs. Another pile of raw silk is in the side corner.Must be a secret stash hidden by someone.

You can see Raw Silk here.

>i
You are carrying:
  Golden Brick
  Historical Books
  White shirt
  Jeans
  Glasses
  Prototype watch
  an orange backpack (open but empty)

>drop brick
Dropped.

>i
You are carrying:
  Historical Books
  White shirt
  Jeans
  Glasses
  Prototype watch
  an orange backpack (open but empty)

>look
Mysterious Room
A hidden room lighted with lit candles instead of bright light bulbs.Stacks of golden bricks fill the entire room. Another pile of raw silk is in the side corner.Must be a secret stash hidden by someone.

You can see Golden Brick and Raw Silk here.

>take brick
Taken.

>take raw silk
You take a handful of the silk. It is so soft and smooth, almost as if you're grabbing air!

>i
You are carrying:
  Raw Silk
  Golden Brick
  Historical Books
  White shirt
  Jeans
  Glasses
  Prototype watch
  an orange backpack (open but empty)

>w
The Pristine Library
The library is embedded with silver crystals all around the walls. There are shelves that contain thousands of historical books that date back to your time. A clear glass door is on the far side of the library along with a painting of a prestigious man.
The facial salon is to the north, and lab room is to the west.

>w
Lab Room
It is very gloomy in here with its spherical lights. You can vaguely see equpiment that you have in your very own lab room as well. The desks and chairs are covered in cob webs. The lab shelves are high up with shiny objects on the top. The walls are completely white with faded designs on them.
The outback dump is to the south, pristine library is to the east, garage to the west, and aurora walk is to the north.

>w
Garage
This must be someone's garage. Definately not yours, that's for sure. Many intricate tools and devices hang from the walls and racks. A marvelous car is parked in the middle of it!

Such an incredible piece of work! The car is slick and skinny. A white coat of paint is layered on the whole car and you can even see your own reflection! A black trim goes all around the sides, with blue tinted windows. Surprisingly there are no tires, and exhaust pipes stick out from the back of the car A fairly large bar code is inscribed on the trunk.

>e
Lab Room
It is very gloomy in here with its spherical lights. You can vaguely see equpiment that you have in your very own lab room as well. The desks and chairs are covered in cob webs. The lab shelves are high up with shiny objects on the top. The walls are completely white with faded designs on them.
The outback dump is to the south, pristine library is to the east, garage to the west, and aurora walk is to the north.

>w
Garage
This must be someone's garage. Definately not yours, that's for sure. Many intricate tools and devices hang from the walls and racks. A marvelous car is parked in the middle of it!

Such an incredible piece of work! The car is slick and skinny. A white coat of paint is layered on the whole car and you can even see your own reflection! A black trim goes all around the sides, with blue tinted windows. Surprisingly there are no tires, and exhaust pipes stick out from the back of the car A fairly large bar code is inscribed on the trunk.

>n
Tech Building
A Medium Sized robot is the only thing on the floor around the building. Programers are focused on their work on building more of these robots.

You can see Medium Sized Robot here.

>s
Garage
This must be someone's garage. Definately not yours, that's for sure. Many intricate tools and devices hang from the walls and racks. A marvelous car is parked in the middle of it!

Such an incredible piece of work! The car is slick and skinny. A white coat of paint is layered on the whole car and you can even see your own reflection! A black trim goes all around the sides, with blue tinted windows. Surprisingly there are no tires, and exhaust pipes stick out from the back of the car A fairly large bar code is inscribed on the trunk.

>w
Floating Sidewalk
A luminated clear pathway slowly elevates as you walk farther up onto it. Metal handbars line the edges of the clear floating path. It feels as if you're walking on a cloud, but looks like a beam of light!

>e
Garage
This must be someone's garage. Definately not yours, that's for sure. Many intricate tools and devices hang from the walls and racks. A marvelous car is parked in the middle of it!

Such an incredible piece of work! The car is slick and skinny. A white coat of paint is layered on the whole car and you can even see your own reflection! A black trim goes all around the sides, with blue tinted windows. Surprisingly there are no tires, and exhaust pipes stick out from the back of the car A fairly large bar code is inscribed on the trunk.

>s
Obscure Parking Lot
An eighteen foot parking structure that allows you to park your car whenever you want.

>n
Garage
This must be someone's garage. Definately not yours, that's for sure. Many intricate tools and devices hang from the walls and racks. A marvelous car is parked in the middle of it!

Such an incredible piece of work! The car is slick and skinny. A white coat of paint is layered on the whole car and you can even see your own reflection! A black trim goes all around the sides, with blue tinted windows. Surprisingly there are no tires, and exhaust pipes stick out from the back of the car A fairly large bar code is inscribed on the trunk.

>w
Floating Sidewalk
A luminated clear pathway slowly elevates as you walk farther up onto it. Metal handbars line the edges of the clear floating path. It feels as if you're walking on a cloud, but looks like a beam of light!

40 minutes passed already. Wow! You haven't been checking your time lately.

>e
Garage
This must be someone's garage. Definately not yours, that's for sure. Many intricate tools and devices hang from the walls and racks. A marvelous car is parked in the middle of it!

Such an incredible piece of work! The car is slick and skinny. A white coat of paint is layered on the whole car and you can even see your own reflection! A black trim goes all around the sides, with blue tinted windows. Surprisingly there are no tires, and exhaust pipes stick out from the back of the car A fairly large bar code is inscribed on the trunk.

>w
Floating Sidewalk
A luminated clear pathway slowly elevates as you walk farther up onto it. Metal handbars line the edges of the clear floating path. It feels as if you're walking on a cloud, but looks like a beam of light!

>n
Thirft Shop
An old-school, yet reimaged look of a Thirft Shop. The racks of clothes and hangers automatically rotate once you are done looking at them. Most of the stuff here dates back to 2010. Looks fairly brand new and in style.

>s
Floating Sidewalk
A luminated clear pathway slowly elevates as you walk farther up onto it. Metal handbars line the edges of the clear floating path. It feels as if you're walking on a cloud, but looks like a beam of light!

>w
Lockdown
The prison cells are extremely small. The whole entire Lockdown contain chunks of the luminated steel that emerge from underneath the ground, and move guards toward each cell. The cell bars and walls are also made out of the same material as the floor. At least twenty guards are lined up around each corner of the jail.

>s
You can't go that way.

>e
Floating Sidewalk
A luminated clear pathway slowly elevates as you walk farther up onto it. Metal handbars line the edges of the clear floating path. It feels as if you're walking on a cloud, but looks like a beam of light!

>s
Directional Path
You are now on cement again. The texture of this pathway is much different from the Floating Sidewalk. A brown silk bag is lying on the side of the pathway.

You can see a bag (closed) here.

>n
Floating Sidewalk
A luminated clear pathway slowly elevates as you walk farther up onto it. Metal handbars line the edges of the clear floating path. It feels as if you're walking on a cloud, but looks like a beam of light!

>w
Lockdown
The prison cells are extremely small. The whole entire Lockdown contain chunks of the luminated steel that emerge from underneath the ground, and move guards toward each cell. The cell bars and walls are also made out of the same material as the floor. At least twenty guards are lined up around each corner of the jail.

No worries, 50 minutes passed. About 40 minutes to go.

>n
You can't go that way.

>w
You can't go that way.

>s
You can't go that way.

* * *

>s
Directional Path
You are now on cement again. The texture of this pathway is much different from the Floating Sidewalk. A brown silk bag is lying on the side of the pathway.

You can see a bag (closed) here.

>e
You can't go that way.

>w
You can't go that way.

>n
Floating Sidewalk
A luminated clear pathway slowly elevates as you walk farther up onto it. Metal handbars line the edges of the clear floating path. It feels as if you're walking on a cloud, but looks like a beam of light!

>s
Directional Path
You are now on cement again. The texture of this pathway is much different from the Floating Sidewalk. A brown silk bag is lying on the side of the pathway.

You can see a bag (closed) here.

>s
Elevator Shaft
Yellow tape borders the edges of the elevator. Near the elevator shaft are tools probably left from the workers. Seems as though the elevator is out of function and the workers are on their lunch break.

Your watch is starting to beep. Probably is trying to remind you to hurry up!

I beg your pardon?

>n
Directional Path
You are now on cement again. The texture of this pathway is much different from the Floating Sidewalk. A brown silk bag is lying on the side of the pathway.

You can see a bag (closed) here.

>e
You can't go that way.

>n
Floating Sidewalk
A luminated clear pathway slowly elevates as you walk farther up onto it. Metal handbars line the edges of the clear floating path. It feels as if you're walking on a cloud, but looks like a beam of light!

>e
Garage
This must be someone's garage. Definately not yours, that's for sure. Many intricate tools and devices hang from the walls and racks. A marvelous car is parked in the middle of it!

Such an incredible piece of work! The car is slick and skinny. A white coat of paint is layered on the whole car and you can even see your own reflection! A black trim goes all around the sides, with blue tinted windows. Surprisingly there are no tires, and exhaust pipes stick out from the back of the car A fairly large bar code is inscribed on the trunk.

>e
Lab Room
It is very gloomy in here with its spherical lights. You can vaguely see equpiment that you have in your very own lab room as well. The desks and chairs are covered in cob webs. The lab shelves are high up with shiny objects on the top. The walls are completely white with faded designs on them.
The outback dump is to the south, pristine library is to the east, garage to the west, and aurora walk is to the north.

>s
Outback Dump
A room made specially for trash and filthy chemicals. It reeks of carbon and a large dumpster is in the center of the room. A bunch of spiders are scattered all over the place. Disgusting.

>e
You can't go that way.

* * *

>s
You can't go that way.

>n
Lab Room
It is very gloomy in here with its spherical lights. You can vaguely see equpiment that you have in your very own lab room as well. The desks and chairs are covered in cob webs. The lab shelves are high up with shiny objects on the top. The walls are completely white with faded designs on them.
The outback dump is to the south, pristine library is to the east, garage to the west, and aurora walk is to the north.

>n
Aurora Walk
This seems to be the main walkway for many people. It is busy and lots of rubbish is littered on the ground. A trash can is always available yet no one has the decency to throw the trash into it. The ground is made up of a thick green cushiony pad. Many of the pedestrians are walking by and minding their own buisiness.

>s
Lab Room
It is very gloomy in here with its spherical lights. You can vaguely see equpiment that you have in your very own lab room as well. The desks and chairs are covered in cob webs. The lab shelves are high up with shiny objects on the top. The walls are completely white with faded designs on them.
The outback dump is to the south, pristine library is to the east, garage to the west, and aurora walk is to the north.

>n
Aurora Walk
This seems to be the main walkway for many people. It is busy and lots of rubbish is littered on the ground. A trash can is always available yet no one has the decency to throw the trash into it. The ground is made up of a thick green cushiony pad. Many of the pedestrians are walking by and minding their own buisiness.

>e
Facial Salon
A pretty beautician in the back of the counter is waiting to greet people as they walk through. The aroma of strawberry surrounds the salon. Lots of thin silk and hair is scattered all over the checker-board floor and tabletops. The fancy light blue lights gives the room a nice "cool" feeling to it. Silk seems to have been excreted from the tiny holes of the lights for some reason. White leather seats around the mirrors make up almost the entire salon.

>w
Aurora Walk
This seems to be the main walkway for many people. It is busy and lots of rubbish is littered on the ground. A trash can is always available yet no one has the decency to throw the trash into it. The ground is made up of a thick green cushiony pad. Many of the pedestrians are walking by and minding their own buisiness. 

No time to waste, do what you gotta do now. And quick!

>w
Tech Building
A Medium Sized robot is the only thing on the floor around the building. Programers are focused on their work on building more of these robots.

You can see Medium Sized Robot here.

>e
Aurora Walk
This seems to be the main walkway for many people. It is busy and lots of rubbish is littered on the ground. A trash can is always available yet no one has the decency to throw the trash into it. The ground is made up of a thick green cushiony pad. Many of the pedestrians are walking by and minding their own buisiness.

>n
DNA Beach
Surfs-up! Seems as though everyone's at the beach today. A sign shows the reports of the day. Many beach blankets cover the bed of sand. A red box lies underneath the analysis sign.

>s
Aurora Walk
This seems to be the main walkway for many people. It is busy and lots of rubbish is littered on the ground. A trash can is always available yet no one has the decency to throw the trash into it. The ground is made up of a thick green cushiony pad. Many of the pedestrians are walking by and minding their own buisiness.

>e
Facial Salon
A pretty beautician in the back of the counter is waiting to greet people as they walk through. The aroma of strawberry surrounds the salon. Lots of thin silk and hair is scattered all over the checker-board floor and tabletops. The fancy light blue lights gives the room a nice "cool" feeling to it. Silk seems to have been excreted from the tiny holes of the lights for some reason. White leather seats around the mirrors make up almost the entire salon.

>n
You can't go that way.

>w
Aurora Walk
This seems to be the main walkway for many people. It is busy and lots of rubbish is littered on the ground. A trash can is always available yet no one has the decency to throw the trash into it. The ground is made up of a thick green cushiony pad. Many of the pedestrians are walking by and minding their own buisiness.

>e
Facial Salon
A pretty beautician in the back of the counter is waiting to greet people as they walk through. The aroma of strawberry surrounds the salon. Lots of thin silk and hair is scattered all over the checker-board floor and tabletops. The fancy light blue lights gives the room a nice "cool" feeling to it. Silk seems to have been excreted from the tiny holes of the lights for some reason. White leather seats around the mirrors make up almost the entire salon.

>s
The Pristine Library
The library is embedded with silver crystals all around the walls. There are shelves that contain thousands of historical books that date back to your time. A clear glass door is on the far side of the library along with a painting of a prestigious man.
The facial salon is to the north, and lab room is to the west.

>n
Facial Salon
A pretty beautician in the back of the counter is waiting to greet people as they walk through. The aroma of strawberry surrounds the salon. Lots of thin silk and hair is scattered all over the checker-board floor and tabletops. The fancy light blue lights gives the room a nice "cool" feeling to it. Silk seems to have been excreted from the tiny holes of the lights for some reason. White leather seats around the mirrors make up almost the entire salon.

>n
You can't go that way.

>e
You can't go that way.

>w
Aurora Walk
This seems to be the main walkway for many people. It is busy and lots of rubbish is littered on the ground. A trash can is always available yet no one has the decency to throw the trash into it. The ground is made up of a thick green cushiony pad. Many of the pedestrians are walking by and minding their own buisiness.

>w
Tech Building
A Medium Sized robot is the only thing on the floor around the building. Programers are focused on their work on building more of these robots.

You can see Medium Sized Robot here.

>n
You can't go that way.

You are out of time… Your watch has teleported you back to your very own lab with your orange backpack. Hopefully you managed to take enough stuff with you back home.

    *** You have won ***

In that game you scored 150 out of a possible 1500, in 91 turns.

Would you like to RESTART, RESTORE a saved game, QUIT or UNDO the last command?

* * *

>take black book
You found a hidden lever!

Taken.

>pull lever
You found a hidden door to the east! Wonder where that leads to.

[Your score has just gone up by one hundred and fifty points.]

>e
Mysterious Room
A hidden room lighted with lit candles instead of bright light bulbs. Stacks of golden bricks fill the entire room. Another pile of raw silk is in the side corner. Must be a secret stash hidden by someone.
The pristine library is to the west.

>take golden bricks
Unfortunately, you are only strong enough to hold one of the bars.

>i
You are carrying:
  Golden Brick
  Black Book
  an orange backpack (open but empty)
  White shirt
  Jeans
  Glasses
  Prototype watch

>take golden brick
You already have that.

>take raw silk
You take a handful of the silk. It is so soft and smooth, almost as if you're grabbing air!

>i
You are carrying:
  Raw Silk
  Golden Brick
  Black Book
  an orange backpack (open but empty)
  White shirt
  Jeans
  Glasses
  Prototype watch

>w
The Pristine Library
The library is embedded with silver crystals all around the walls. There are shelves that contain thousands of historical books that date back to your time. A clear glass door is on the far side of the library along with a painting of a prestigious man.
The facial salon is to the north, and lab room is to the west.

* * *

>w
Lab Room
It is very gloomy in here with its spherical lights. You can vaguely see equpiment that you have in your very own lab room as well. The desks and chairs are covered in cob webs. The lab shelves are high up with shiny objects on the top. The walls are completely white with faded designs on them.
The outback dump is to the south, pristine library is to the east, garage to the west, and aurora walk is to the north.

>take batteries
You pick up the electrical batteries.

>n
Aurora Walk
This seems to be the main walkway for many people. It is busy and lots of rubbish is littered on the ground. A trash can is always available yet no one has the decency to throw the trash into it. The ground is made up of a thick green cushiony pad. Many of the pedestrians are walking by and minding their own buisiness.
The lab room is to the south, facial salon to the east, tech building to the west, and DNA beach to the north.

>w
Tech Building
A Medium Sized robot is the only thing on the floor around the building. Programers are focused on their work on building more of these robots.
The garage is to the south, aurora walk to the east, and thrift shop to the west.

You can see Medium Sized Robot here.

>give batteries to robot
The robot starts to dance to the tune of Call Me Maybe by Carly Rae Jepson. It walks all over the place.

* * *

>i
You are carrying:
  Golden Brick
  Black Book
  an orange backpack (open but empty)
  White shirt
  Jeans
  Glasses
  Prototype watch

>look
Mysterious Room
A hidden room lighted with lit candles instead of bright light bulbs. Stacks of golden bricks fill the entire room. Another pile of raw silk is in the side corner. Must be a secret stash hidden by someone.
The pristine library is to the west.

>take raw silk
You take a handful of the silk. It is so soft and smooth, almost as if you're grabbing air!

* * *

>i
You are carrying:
  Raw Silk
  Golden Brick
  Black Book
  an orange backpack (open but empty)
  White shirt
  Jeans
  Glasses
  Prototype watch

>look
Mysterious Room
A hidden room lighted with lit candles instead of bright light bulbs. Stacks of golden bricks fill the entire room.  Must be a secret stash hidden by someone.
The pristine library is to the west.

>take golden bricks
Unfortunately, you are only strong enough to hold one of the bars.

>i
You are carrying:
  Golden Brick
  Raw Silk
  Black Book
  an orange backpack (open but empty)
  White shirt
  Jeans
  Glasses
  Prototype watch

>put golden brick into backpack
You put Golden Brick into the orange backpack.

* * *

>e
The Pristine Library
The library is embedded with silver crystals all around the walls. There are shelves that contain thousands of historical books that date back to your time. A clear glass door is on the far side of the library along with a painting of a prestigious man.
The facial salon is to the north, and lab room is to the west.

>take crystals
Taken.

>put crystals inside backpack
You put Silver Crystals into the orange backpack.

>i
You are carrying:
  White shirt
  Jeans
  Glasses
  Prototype watch
  an orange backpack (open)
    Silver Crystals

* * *

>put crystals inside backpack
You put Silver Crystals into the orange backpack.

>x shelves
Glass shelves that hold many books arranged in alphabetical order. There is one black book that seems to be jutting out a little too far than the others.

* * *

>pull lever
You found a hidden door to the east! Wonder where that leads to.

[Your score has just gone up by one hundred and fifty points.]

>e
Mysterious Room
A hidden room lighted with lit candles instead of bright light bulbs. Another pile of raw silk is in the side corner. Must be a secret stash hidden by someone.
The pristine library is to the west.

>x golden brick
I only understood you as far as wanting to examine Golden Bricks.

>take brick
You can't see any such thing.

>take golden brick
I only understood you as far as wanting to take Golden Bricks.

>take golden bricks
Unfortunately, you are only strong enough to hold one of the bars.

>drop bricks
Golden Bricks is already here.

>i
You are carrying:
  Golden Brick
  Black Book
  an orange backpack (open)
    Silver Crystals
  White shirt
  Jeans
  Glasses
  Prototype watch

>drop golden brick
Dropped.

>l,ook
Mysterious Room
A hidden room lighted with lit candles instead of bright light bulbs.Stacks of golden bricks fill the entire room. Another pile of raw silk is in the side corner. Must be a secret stash hidden by someone.
The pristine library is to the west.

You can see Golden Brick here.

That's not a verb I recognise.

>look
Mysterious Room
A hidden room lighted with lit candles instead of bright light bulbs.Stacks of golden bricks fill the entire room. Another pile of raw silk is in the side corner. Must be a secret stash hidden by someone.
The pristine library is to the west.

You can see Golden Brick here.

* * *

>e
The Pristine Library
The library is embedded with silver crystals all around the walls. There are shelves that contain thousands of historical books that date back to your time. A clear glass door is on the far side of the library along with a painting of a prestigious man.
The facial salon is to the north, and lab room is to the west.

>x crystals
Shiny and smooth crystals that gives the library an amazing glow.

>take crystals
[Your score has just gone up by five points.]

>i
You are carrying:
  Silver Crystals
  White shirt
  Jeans
  Glasses
  Prototype watch
  an orange backpack (open but empty)

* * *

>w
Garage
This must be someone's garage. Definately not yours, that's for sure. Many intricate tools and devices hang from the walls and racks. A marvelous car is parked in the middle of it!
The lab room is to the east, floating sidewalk to the west, tech building to the north, and obscure parking lot to the south.

Such an incredible piece of work! The car is slick and skinny. A white coat of paint is layered on the whole car and you can even see your own reflection! A black trim goes all around the sides, with blue tinted windows. Surprisingly there are no tires, and exhaust pipes stick out from the back of the car A fairly large bar code is inscribed on the trunk.

>w
Floating Sidewalk
A luminated clear pathway slowly elevates as you walk farther up onto it. Metal handbars line the edges of the clear floating path. It feels as if you're walking on a cloud, but looks like a beam of light!
The garage is to the east, the lockdown to the west, thrift shop to the north, and directional path to the south.

>s
Directional Path
You are now on cement again. The texture of this pathway is much different from the Floating Sidewalk. A brown silk bag is lying on the side of the pathway.
The floating sidewalk is to the north, and elevator shaft to the south.

You can see a bag (closed) here.

>s
Elevator Shaft
Yellow tape borders the edges of the elevator. Near the elevator shaft are tools probably left from the workers. Seems as though the elevator is out of function and the workers are on their lunch break.
The obscure parking lot is to the east, and directional path to the north.

>s
You can't go that way.

>e
Obscure Parking Lot
An eighteen foot parking structure that allows you to park your car whenever you want.
The garage is to the north, elevator shaft to the west, and skyscraper 057 to the east.

>e
Skyscraper 057
The largest building in the vicinity. It is filled with many people trying to buy and sell their products amongst many business owners.  Low square desks and pillows make up the whole floor. You can go through the sliding door that leads to the top of the Skyscraper. A young little girl is huddled in the corner as tears rush down her face. Where are her parents? How strange.
The obscure parking lot is to the west, stairway to the north, and plaza streets to the east.

You can see Pillows here.

>n
(first opening Sliding Door)

Stairway
Just an empty stairway. Wonder where this leads to.
The skyscraper 057 is to the south, and skyscraper view to the north.

>n
Skyscraper View
What an amazing sight to see. Long metal poles stretch across the edges of the skyscraper for safety. There's a nice breeze at the top of the Skyscraper. You can see almost everything from here, how fantastic. Just don't look down.
The Stairway is to the south.

>n
You can't go that way.

* * *

>w
You can't go that way.

>s
Stairway
Just an empty stairway. Wonder where this leads to.
The skyscraper 057 is to the south, and skyscraper view to the north.

>s
Skyscraper 057
The largest building in the vicinity. It is filled with many people trying to buy and sell their products amongst many business owners.  Low square desks and pillows make up the whole floor. You can go through the sliding door that leads to the top of the Skyscraper. A young little girl is huddled in the corner as tears rush down her face. Where are her parents? How strange.
The obscure parking lot is to the west, stairway to the north, and plaza streets to the east.

You can see Pillows here.

>n
Stairway
Just an empty stairway. Wonder where this leads to.
The skyscraper 057 is to the south, and skyscraper view to the north.

>n
Skyscraper View
What an amazing sight to see. Long metal poles stretch across the edges of the skyscraper for safety. There's a nice breeze at the top of the Skyscraper. You can see almost everything from here, how fantastic. Just don't look down.
The Stairway is to the south.

>s
Stairway
Just an empty stairway. Wonder where this leads to.
The skyscraper 057 is to the south, and skyscraper view to the north.

* * *

>s
Skyscraper 057
The largest building in the vicinity. It is filled with many people trying to buy and sell their products amongst many business owners.  Low square desks and pillows make up the whole floor. You can go through the sliding door that leads to the top of the Skyscraper. A young little girl is huddled in the corner as tears rush down her face. Where are her parents? How strange.
The obscure parking lot is to the west, stairway to the north, and plaza streets to the east.

You can see Pillows here.

>e
Plaza Streets
People hustle and bustle around the plaza. A large fish fountain with a statue of a person is located in the center of it. The ground is filled with black and blue tiles around the plaza. What a sight.

I beg your pardon?

>n
You can't go that way.

>w
Skyscraper 057
The largest building in the vicinity. It is filled with many people trying to buy and sell their products amongst many business owners.  Low square desks and pillows make up the whole floor. You can go through the sliding door that leads to the top of the Skyscraper. A young little girl is huddled in the corner as tears rush down her face. Where are her parents? How strange.
The obscure parking lot is to the west, stairway to the north, and plaza streets to the east.

You can see Pillows here.

>e
Plaza Streets
People hustle and bustle around the plaza. A large fish fountain with a statue of a person is located in the center of it. The ground is filled with black and blue tiles around the plaza. What a sight.

>e
You can't go that way.

>s
Pear Incorporation
This is surprising to see that Apple has a rival in their industry. Hundreds of devices are scattered on the wooden desks around the room. The Pear Inc. workers are ready to assist anyone that needs help.

>n
Plaza Streets
People hustle and bustle around the plaza. A large fish fountain with a statue of a person is located in the center of it. The ground is filled with black and blue tiles around the plaza. What a sight.

>s
Pear Incorporation
This is surprising to see that Apple has a rival in their industry. Hundreds of devices are scattered on the wooden desks around the room. The Pear Inc. workers are ready to assist anyone that needs help.

>w
You can't go that way.

>e
You can't go that way.

>s
You can't go that way.

* * *

>e
Lab Room
It is very gloomy in here with its spherical lights. You can vaguely see equpiment that you have in your very own lab room as well. The desks and chairs are covered in cob webs. The lab shelves are high up with shiny objects on the top. The walls are completely white with faded designs on them.
The outback dump is to the south, pristine library is to the east, garage to the west, and aurora walk is to the north.

>n
Aurora Walk
This seems to be the main walkway for many people. It is busy and lots of rubbish is littered on the ground. A trash can is always available yet no one has the decency to throw the trash into it. The ground is made up of a thick green cushiony pad. Many of the pedestrians are walking by and minding their own buisiness.
The lab room is to the south, facial salon to the east, tech building to the west, and DNA beach to the north.

>e
Facial Salon
A pretty beautician in the back of the counter is waiting to greet people as they walk through. The aroma of strawberry surrounds the salon. Lots of thin silk and hair is scattered all over the checker-board floor and tabletops. The fancy light blue lights gives the room a nice "cool" feeling to it. Silk seems to have been excreted from the tiny holes of the lights for some reason. White leather seats around the mirrors make up almost the entire salon.
The aurora walk is to the west, and pristine library to the south.

>x seats
A white leather seat that has a circlular opening for you to lay your head on. A thin plastic triangular cutout is laying on one of the white leather seats.

>take cutout
Taken.

>x cutout
A plastic triangular figure that someone left on the seat. Maybe you can combine this with something else.

* * *

>lights
That's not a verb I recognise.

>lights
That's not a verb I recognise.

>x lights
A shady dark blue light that compliments that white walls of the lab room.

>take lights
That's hardly portable.

>x equipment
A Volumetric Flask, beaker, work gloves, and a goggle make up the equipment.

>x flask
Used to mix different chemicals in, and create experiments.

>x beaker
A lipped cylindrical glass container used by chemists.

>x gloves
White elastic gloves that stretch onto your hand. Just in case you get the chemicals on your hand.

>put on gloves
(first taking Work gloves)
You put on Work gloves.

>put on goggle
(first taking Goggle)
You put on Goggle.

>i
You are carrying:
  Goggle (being worn)
  Work gloves (being worn)
  White shirt
  Jeans
  Glasses
  Prototype watch
  an orange backpack (open but empty)

* * *

>orth
That's not a verb I recognise.

>west
Garage
This must be someone's garage. Definately not yours, that's for sure. Many intricate tools and devices hang from the walls and racks. A marvelous car is parked in the middle of it!

Such an incredible piece of work! The car is slick and skinny. A white coat of paint is layered on the whole car and you can even see your own reflection! A black trim goes all around the sides, with blue tinted windows. Surprisingly there are no tires, and exhaust pipes stick out from the back of the car A fairly large bar code is inscribed on the trunk.

>north
You can't go that way.

>north
You can't go that way.

>east
Lab Room
It is very gloomy in here with its spherical lights. You can vaguely see equpiment that you have in your very own lab room as well. The desks and chairs are covered in cob webs, with different flasks that contain unique chemicals inside them. The lab shelves are high up with shiny objects on the top. The walls are completely white with faded designs on them. An orange container is in here as well so that you can put all your findings into here and take them back home with you.

>north
Aurora Walk
This seems to be the main walkway for many people. It is busy and lots of trash is littered on the ground. The ground is made up of a thick green cushiony pad.

>west
Tech Building
Miniature sized robots cover the floor around the building. Programers focused on their work on building more of these tiny robots.

>north
Jump
A long and twelve foot wall that juts out of the land connected to the beach.

>south
Tech Building
Miniature sized robots cover the floor around the building. Programers focused on their work on building more of these tiny robots.

>south
You can't go that way.

>west
Old Thirft Shop
An old-school yet reimaged look of a Thirft Shop. The racks of clothes and hangers automatically rotate once you are done looking at them. Most of the stuff here dates back to 2010. Looks fairly brand new and in style.

>south
Floating Sidewalk
A luminated clear pathway slowly elevates as you walk farther up onto it. Metal handbars line the edges of the clear floating path. It feels as if you're walking on a cloud, but looks like a beam of light!

>east
Garage
This must be someone's garage. Definately not yours, that's for sure. Many intricate tools and devices hang from the walls and racks. A marvelous car is parked in the middle of it!

Such an incredible piece of work! The car is slick and skinny. A white coat of paint is layered on the whole car and you can even see your own reflection! A black trim goes all around the sides, with blue tinted windows. Surprisingly there are no tires, and exhaust pipes stick out from the back of the car A fairly large bar code is inscribed on the trunk.

>north
You can't go that way.

* * *

>east
Lab Room
It is very gloomy in here with its spherical lights. You can vaguely see equpiment that you have in your very own lab room as well. The desks and chairs are covered in cob webs, with different flasks that contain unique chemicals inside them. The lab shelves are high up with shiny objects on the top. The walls are completely white with faded designs on them. An orange container is in here as well so that you can put all your findings into here and take them back home with you.

>west
Garage
This must be someone's garage. Definately not yours, that's for sure. Many intricate tools and devices hang from the walls and racks. A marvelous car is parked in the middle of it!

Such an incredible piece of work! The car is slick and skinny. A white coat of paint is layered on the whole car and you can even see your own reflection! A black trim goes all around the sides, with blue tinted windows. Surprisingly there are no tires, and exhaust pipes stick out from the back of the car A fairly large bar code is inscribed on the trunk.

>west
Floating Sidewalk
A luminated clear pathway slowly elevates as you walk farther up onto it. Metal handbars line the edges of the clear floating path. It feels as if you're walking on a cloud, but looks like a beam of light!

You realize that you have only fifteen more minutes to get the cat into his carrier.

>east
Garage
This must be someone's garage. Definately not yours, that's for sure. Many intricate tools and devices hang from the walls and racks. A marvelous car is parked in the middle of it!

Such an incredible piece of work! The car is slick and skinny. A white coat of paint is layered on the whole car and you can even see your own reflection! A black trim goes all around the sides, with blue tinted windows. Surprisingly there are no tires, and exhaust pipes stick out from the back of the car A fairly large bar code is inscribed on the trunk.

* * *

>i
You are carrying:
  White shirt
  Jeans
  Glasses
  Prototype watch
  an orange backpack (open but empty)

>put jeans into backpack
You put Jeans into the orange backpack.

>i
You are carrying:
  White shirt
  Glasses
  Prototype watch
  an orange backpack (open)
    Jeans

>e
The Pristine Library
The library is embedded with silver crystals all around the walls. There are shelves that contain thousands of historical books that date back to your time. A clear glass door is on the far side of the library along with a painting of a prestigious man.

>w
Lab Room
It is very gloomy in here with its spherical lights. You can vaguely see equpiment that you have in your very own lab room as well. The desks and chairs are covered in cob webs. The lab shelves are high up with shiny objects on the top. The walls are completely white with faded designs on them. An orange backpack is in here as well so that you can put all your findings into it and take them back home with you.

>n
Aurora Walk
This seems to be the main walkway for many people. It is busy and lots of rubbish is littered on the ground. A trash can is always available yet no one has the decency to throw the trash into it. The ground is made up of a thick green cushiony pad.

>x trash
A dark blue trash can with a clear glass rim that opens automatically when it senses someone's hands nearby.

>x rubbish
Remnants of used kleenex and recylable bottles that are scattered on the walkway.

>x kleenex
Shredded up pieces of tissue paper that is crumpled up and already used. Nasty!

>take kleenex
Are you sure you really want to take it? You really don't need it at all.

>i
You are carrying:
  White shirt
  Glasses
  Prototype watch
  an orange backpack (open)
    Jeans

* * *

>n
Aurora Walk
This seems to be the main walkway for many people. It is busy and lots of rubbish is littered on the ground. A trash can is always available yet no one has the decency to throw the trash into it. The ground is made up of a thick green cushiony pad. Many of the pedestrians are walking by and minding their own buisiness.
The lab room is to the south, facial salon to the east, tech building to the west, and DNA beach to the north.

* * *

>w
Tech Building
A Medium Sized robot is the only thing on the floor around the building. Programers are focused on their work on building more of these robots.
The garage is to the south, aurora walk to the east, and thrift shop to the west.

You can see Medium Sized Robot here.

>w
Thirft Shop
An old-school, yet reimaged look of a Thirft Shop. The racks of clothes and hangers automatically rotate once you are done looking at them. Most of the stuff here dates back to 2010. Looks fairly brand new and in style.
The tech building is to the east, and floating sidewalk to the south.

>e
Tech Building
A Medium Sized robot is the only thing on the floor around the building. Programers are focused on their work on building more of these robots.
The garage is to the south, aurora walk to the east, and thrift shop to the west.

You can see Medium Sized Robot here.

>n
You can't go that way.

>s
Garage
This must be someone's garage. Definately not yours, that's for sure. Many intricate tools and devices hang from the walls and racks. A marvelous car is parked in the middle of it!
The lab room is to the east, floating sidewalk to the west, tech building to the north, and obscure parking lot to the south.

Such an incredible piece of work! The car is slick and skinny. A white coat of paint is layered on the whole car and you can even see your own reflection! A black trim goes all around the sides, with blue tinted windows. Surprisingly there are no tires, and exhaust pipes stick out from the back of the car A fairly large bar code is inscribed on the trunk.

>n
Tech Building
A Medium Sized robot is the only thing on the floor around the building. Programers are focused on their work on building more of these robots.
The garage is to the south, aurora walk to the east, and thrift shop to the west.

You can see Medium Sized Robot here.

>e
Aurora Walk
This seems to be the main walkway for many people. It is busy and lots of rubbish is littered on the ground. A trash can is always available yet no one has the decency to throw the trash into it. The ground is made up of a thick green cushiony pad. Many of the pedestrians are walking by and minding their own buisiness.
The lab room is to the south, facial salon to the east, tech building to the west, and DNA beach to the north.

>w
Tech Building
A Medium Sized robot is the only thing on the floor around the building. Programers are focused on their work on building more of these robots.
The garage is to the south, aurora walk to the east, and thrift shop to the west.

You can see Medium Sized Robot here.

>e
Aurora Walk
This seems to be the main walkway for many people. It is busy and lots of rubbish is littered on the ground. A trash can is always available yet no one has the decency to throw the trash into it. The ground is made up of a thick green cushiony pad. Many of the pedestrians are walking by and minding their own buisiness.
The lab room is to the south, facial salon to the east, tech building to the west, and DNA beach to the north.

* * *

>w
Tech Building
A Medium Sized robot is the only thing on the floor around the building. Programers are focused on their work on building more of these robots.
The garage is to the south, aurora walk to the east, and thrift shop to the west.

You can see Medium Sized Robot here.

>s
Garage
This must be someone's garage. Definately not yours, that's for sure. Many intricate tools and devices hang from the walls and racks. A marvelous car is parked in the middle of it!
The lab room is to the east, floating sidewalk to the west, tech building to the north, and obscure parking lot to the south.

Such an incredible piece of work! The car is slick and skinny. A white coat of paint is layered on the whole car and you can even see your own reflection! A black trim goes all around the sides, with blue tinted windows. Surprisingly there are no tires, and exhaust pipes stick out from the back of the car A fairly large bar code is inscribed on the trunk.

* * *

>n
Tech Building
A Medium Sized robot is the only thing on the floor around the building. Programers are focused on their work on building more of these robots.
The garage is to the south, aurora walk to the east, and thrift shop to the west.

You can see Medium Sized Robot here.

>w
Thirft Shop
An old-school, yet reimaged look of a Thirft Shop. The racks of clothes and hangers automatically rotate once you are done looking at them. Most of the stuff here dates back to 2010. Looks fairly brand new and in style.
The tech building is to the east, and floating sidewalk to the south.

* * *

>e
Tech Building
A Medium Sized robot is the only thing on the floor around the building. Programers are focused on their work on building more of these robots.
The garage is to the south, aurora walk to the east, and thrift shop to the west.

You can see Medium Sized Robot here.

>w
Thirft Shop
An old-school, yet reimaged look of a Thirft Shop. The racks of clothes and hangers automatically rotate once you are done looking at them. Most of the stuff here dates back to 2010. Looks fairly brand new and in style.
The tech building is to the east, and floating sidewalk to the south.

>n
You can't go that way.

* * *

>w
You can't go that way.

>s
Floating Sidewalk
A luminated clear pathway slowly elevates as you walk farther up onto it. Metal handbars line the edges of the clear floating path. It feels as if you're walking on a cloud, but looks like a beam of light!
The garage is to the east, the lockdown to the west, thrift shop to the north, and directional path to the south.

>n
Thirft Shop
An old-school, yet reimaged look of a Thirft Shop. The racks of clothes and hangers automatically rotate once you are done looking at them. Most of the stuff here dates back to 2010. Looks fairly brand new and in style.
The tech building is to the east, and floating sidewalk to the south.

>e
Tech Building
A Medium Sized robot is the only thing on the floor around the building. Programers are focused on their work on building more of these robots.
The garage is to the south, aurora walk to the east, and thrift shop to the west.

You can see Medium Sized Robot here.

* * *

>n
You can't go that way.

>e
Aurora Walk
This seems to be the main walkway for many people. It is busy and lots of rubbish is littered on the ground. A trash can is always available yet no one has the decency to throw the trash into it. The ground is made up of a thick green cushiony pad. Many of the pedestrians are walking by and minding their own buisiness.
The lab room is to the south, facial salon to the east, tech building to the west, and DNA beach to the north.

>n
DNA Beach
Surfs-up! Seems as though everyone's at the beach today. A sign shows the reports of the day. Many beach blankets cover the bed of sand. A red box lies underneath the analysis sign.
The aurora walk is to the south, sandy ocean to the north, and cruising shack to the east.

>s
Aurora Walk
This seems to be the main walkway for many people. It is busy and lots of rubbish is littered on the ground. A trash can is always available yet no one has the decency to throw the trash into it. The ground is made up of a thick green cushiony pad. Many of the pedestrians are walking by and minding their own buisiness.
The lab room is to the south, facial salon to the east, tech building to the west, and DNA beach to the north.

>n
DNA Beach
Surfs-up! Seems as though everyone's at the beach today. A sign shows the reports of the day. Many beach blankets cover the bed of sand. A red box lies underneath the analysis sign.
The aurora walk is to the south, sandy ocean to the north, and cruising shack to the east.

>w
You can't go that way.

>w
You can't go that way.

>n
Sandy Ocean
The ocean is surprisingly clear blue. It looks like coral and large rocks on the bottom of the ocean have been coated with a layer of paint.
The DNA beach is to the south.

>s
DNA Beach
Surfs-up! Seems as though everyone's at the beach today. A sign shows the reports of the day. Many beach blankets cover the bed of sand. A red box lies underneath the analysis sign.
The aurora walk is to the south, sandy ocean to the north, and cruising shack to the east.

>w
You can't go that way.

>s
Aurora Walk
This seems to be the main walkway for many people. It is busy and lots of rubbish is littered on the ground. A trash can is always available yet no one has the decency to throw the trash into it. The ground is made up of a thick green cushiony pad. Many of the pedestrians are walking by and minding their own buisiness.
The lab room is to the south, facial salon to the east, tech building to the west, and DNA beach to the north.

* * *

>n
DNA Beach
Surfs-up! Seems as though everyone's at the beach today. A sign shows the reports of the day. Many beach blankets cover the bed of sand. A red box lies underneath the analysis sign.
The aurora walk is to the south, sandy ocean to the north, and cruising shack to the east.

>e
Cruising Shack
An open cabin made out of wooden planks. A cashier runs the whole place, while people go in and out, grabbing beach gear from the automatic moving beach shelf. Looks like you can just borrow the gear instead of paying.
The DNA Beach is to the west.

Sunny is leaning on the counter inside the Shack waiting for someone to ask for assistance.

>w
DNA Beach
Surfs-up! Seems as though everyone's at the beach today. A sign shows the reports of the day. Many beach blankets cover the bed of sand. A red box lies underneath the analysis sign.
The aurora walk is to the south, sandy ocean to the north, and cruising shack to the east.

>n
Sandy Ocean
The ocean is surprisingly clear blue. It looks like coral and large rocks on the bottom of the ocean have been coated with a layer of paint.
The DNA beach is to the south.

>n
You can't go that way.

* * *

>w
You can't go that way.

>s
DNA Beach
Surfs-up! Seems as though everyone's at the beach today. A sign shows the reports of the day. Many beach blankets cover the bed of sand. A red box lies underneath the analysis sign.
The aurora walk is to the south, sandy ocean to the north, and cruising shack to the east.

>s
Aurora Walk
This seems to be the main walkway for many people. It is busy and lots of rubbish is littered on the ground. A trash can is always available yet no one has the decency to throw the trash into it. The ground is made up of a thick green cushiony pad. Many of the pedestrians are walking by and minding their own buisiness.
The lab room is to the south, facial salon to the east, tech building to the west, and DNA beach to the north.

40 minutes passed already. Wow! You haven't been checking your time lately.

>n
DNA Beach
Surfs-up! Seems as though everyone's at the beach today. A sign shows the reports of the day. Many beach blankets cover the bed of sand. A red box lies underneath the analysis sign.
The aurora walk is to the south, sandy ocean to the north, and cruising shack to the east.

* * *

>w
DNA Beach
Surfs-up! Seems as though everyone's at the beach today. A sign shows the reports of the day. Many beach blankets cover the bed of sand. A red box lies underneath the analysis sign.
The aurora walk is to the south, sandy ocean to the north, and cruising shack to the east.

>e
Cruising Shack
An open cabin made out of wooden planks. A cashier runs the whole place, while people go in and out, grabbing beach gear from the automatic moving beach shelf. Looks like you can just borrow the gear instead of paying.
The DNA Beach is to the west.

Sunny is leaning on the counter inside the Shack waiting for someone to ask for assistance.

>n
You can't go that way.

* * *

>s
You can't go that way.

>w
DNA Beach
Surfs-up! Seems as though everyone's at the beach today. A sign shows the reports of the day. Many beach blankets cover the bed of sand. A red box lies underneath the analysis sign.
The aurora walk is to the south, sandy ocean to the north, and cruising shack to the east.

>w
You can't go that way.

>w
You can't go that way.

No worries, 50 minutes passed. About 40 minutes to go.

>s
Aurora Walk
This seems to be the main walkway for many people. It is busy and lots of rubbish is littered on the ground. A trash can is always available yet no one has the decency to throw the trash into it. The ground is made up of a thick green cushiony pad. Many of the pedestrians are walking by and minding their own buisiness.
The lab room is to the south, facial salon to the east, tech building to the west, and DNA beach to the north.

>w
Tech Building
A Medium Sized robot is the only thing on the floor around the building. Programers are focused on their work on building more of these robots.
The garage is to the south, aurora walk to the east, and thrift shop to the west.

You can see Medium Sized Robot here.

* * *

>w
Thirft Shop
An old-school, yet reimaged look of a Thirft Shop. The racks of clothes and hangers automatically rotate once you are done looking at them. Most of the stuff here dates back to 2010. Looks fairly brand new and in style.
The tech building is to the east, and floating sidewalk to the south.

>s
Floating Sidewalk
A luminated clear pathway slowly elevates as you walk farther up onto it. Metal handbars line the edges of the clear floating path. It feels as if you're walking on a cloud, but looks like a beam of light!
The garage is to the east, the lockdown to the west, thrift shop to the north, and directional path to the south.

>e
Garage
This must be someone's garage. Definately not yours, that's for sure. Many intricate tools and devices hang from the walls and racks. A marvelous car is parked in the middle of it!
The lab room is to the east, floating sidewalk to the west, tech building to the north, and obscure parking lot to the south.

Such an incredible piece of work! The car is slick and skinny. A white coat of paint is layered on the whole car and you can even see your own reflection! A black trim goes all around the sides, with blue tinted windows. Surprisingly there are no tires, and exhaust pipes stick out from the back of the car A fairly large bar code is inscribed on the trunk.

>s
Obscure Parking Lot
An eighteen foot parking structure that allows you to park your car whenever you want.

>w
Elevator Shaft
Yellow tape borders the edges of the elevator. Near the elevator shaft are tools probably left from the workers. Seems as though the elevator is out of function and the workers are on their lunch break.

>e
Obscure Parking Lot
An eighteen foot parking structure that allows you to park your car whenever you want.

>n
Garage
This must be someone's garage. Definately not yours, that's for sure. Many intricate tools and devices hang from the walls and racks. A marvelous car is parked in the middle of it!
The lab room is to the east, floating sidewalk to the west, tech building to the north, and obscure parking lot to the south.

Such an incredible piece of work! The car is slick and skinny. A white coat of paint is layered on the whole car and you can even see your own reflection! A black trim goes all around the sides, with blue tinted windows. Surprisingly there are no tires, and exhaust pipes stick out from the back of the car A fairly large bar code is inscribed on the trunk.

>s
Obscure Parking Lot
An eighteen foot parking structure that allows you to park your car whenever you want.

Your watch is starting to beep. Probably is trying to remind you to hurry up!

>w
Elevator Shaft
Yellow tape borders the edges of the elevator. Near the elevator shaft are tools probably left from the workers. Seems as though the elevator is out of function and the workers are on their lunch break.

* * *

>e
Obscure Parking Lot
An eighteen foot parking structure that allows you to park your car whenever you want.

>e
Skyscraper 057
The largest building in the vicinity. It is filled with many people trying to buy and sell their products amongst many business owners.  Low square desks and pillows make up the whole floor. You can go through the sliding door that leads to the top of the Skyscraper. A young little girl is huddled in the corner as tears rush down her face. Where are her parents? How strange. 

You can see Pillows here.

>w
Obscure Parking Lot
An eighteen foot parking structure that allows you to park your car whenever you want.

>w
Elevator Shaft
Yellow tape borders the edges of the elevator. Near the elevator shaft are tools probably left from the workers. Seems as though the elevator is out of function and the workers are on their lunch break.

>w
There is a string of yellow tape blocking your path.

>s
You can't go that way.

>n
Directional Path
You are now on cement again. The texture of this pathway is much different from the Floating Sidewalk. A brown silk bag is lying on the side of the pathway.
The floating sidewalk is to the north, and elevator shaft to the south.

You can see a bag (closed) here.

>s
Elevator Shaft
Yellow tape borders the edges of the elevator. Near the elevator shaft are tools probably left from the workers. Seems as though the elevator is out of function and the workers are on their lunch break.

>e
Obscure Parking Lot
An eighteen foot parking structure that allows you to park your car whenever you want.

>w
Elevator Shaft
Yellow tape borders the edges of the elevator. Near the elevator shaft are tools probably left from the workers. Seems as though the elevator is out of function and the workers are on their lunch break.

>n
Directional Path
You are now on cement again. The texture of this pathway is much different from the Floating Sidewalk. A brown silk bag is lying on the side of the pathway.
The floating sidewalk is to the north, and elevator shaft to the south.

You can see a bag (closed) here.

* * *

>e
Obscure Parking Lot
An eighteen foot parking structure that allows you to park your car whenever you want.

>e
Skyscraper 057
The largest building in the vicinity. It is filled with many people trying to buy and sell their products amongst many business owners.  Low square desks and pillows make up the whole floor. You can go through the sliding door that leads to the top of the Skyscraper. A young little girl is huddled in the corner as tears rush down her face. Where are her parents? How strange. 

You can see Pillows here.

No time to waste, do what you gotta do now. And quick!

>w
Obscure Parking Lot
An eighteen foot parking structure that allows you to park your car whenever you want.

>e
Skyscraper 057
The largest building in the vicinity. It is filled with many people trying to buy and sell their products amongst many business owners.  Low square desks and pillows make up the whole floor. You can go through the sliding door that leads to the top of the Skyscraper. A young little girl is huddled in the corner as tears rush down her face. Where are her parents? How strange. 

You can see Pillows here.

>s
You can't go that way.

>n
(first opening Sliding Door)

Stairway
Just an empty stairway. Wonder where this leads to.

>e
You can't go that way.

>s
Skyscraper 057
The largest building in the vicinity. It is filled with many people trying to buy and sell their products amongst many business owners.  Low square desks and pillows make up the whole floor. You can go through the sliding door that leads to the top of the Skyscraper. A young little girl is huddled in the corner as tears rush down her face. Where are her parents? How strange. 

You can see Pillows here.

>e
Plaza Streets
People hustle and bustle around the plaza. A large fish fountain with a statue of a person is located in the center of it. The ground is filled with black and blue tiles around the plaza. What a sight.

>w
Skyscraper 057
The largest building in the vicinity. It is filled with many people trying to buy and sell their products amongst many business owners.  Low square desks and pillows make up the whole floor. You can go through the sliding door that leads to the top of the Skyscraper. A young little girl is huddled in the corner as tears rush down her face. Where are her parents? How strange. 

You can see Pillows here.

>n
Stairway
Just an empty stairway. Wonder where this leads to.

>s
Skyscraper 057
The largest building in the vicinity. It is filled with many people trying to buy and sell their products amongst many business owners.  Low square desks and pillows make up the whole floor. You can go through the sliding door that leads to the top of the Skyscraper. A young little girl is huddled in the corner as tears rush down her face. Where are her parents? How strange. 

You can see Pillows here.

>n
Stairway
Just an empty stairway. Wonder where this leads to.

>w
You can't go that way.

* * *

>e
You can't go that way.

>n
Skyscraper View
What an amazing sight to see. Long metal poles stretch across the edges of the skyscraper for safety. There's a nice breeze at the top of the Skyscraper. You can see almost everything from here, how fantastic. Just don't look down.

>n
You can't go that way.

You are out of time… Your watch has teleported you back to your very own lab with your orange backpack. Hopefully you managed to take enough stuff with you back home.

    *** You have won ***

In that game you scored 0 out of a possible 1500, in 91 turns.

Would you like to RESTART, RESTORE a saved game, QUIT or UNDO the last command?

* * *

>w
Thirft Shop
An old-school, yet reimaged look of a Thirft Shop. The racks of clothes and hangers automatically rotate once you are done looking at them. Most of the stuff here dates back to 2010. Looks fairly brand new and in style.
The tech building is to the east, and floating sidewalk to the south.

>x racks
You can't see any such thing.

>x rack
You can't see any such thing.

>take key
You can't see any such thing.

* * *

>THANK U JON
That's not a verb I recognise.

>wait
Time passes.

>n
Aurora Walk
This seems to be the main walkway for many people. It is busy and lots of rubbish is littered on the ground. A trash can is always available yet no one has the decency to throw the trash into it. The ground is made up of a thick green cushiony pad.

>n
DNA Beach
Surfs-up! Seems as though everyone's at the beach today. A sign shows the reports of the day. Many beach blankets cover the bed of sand. A red box lies underneath the analysis sign.

You can see Red Box (closed) here.

>n
Sandy Ocean
The ocean is surprisingly clear blue. It looks like coral and large rocks on the bottom of the ocean have been coated with a layer of paint.

>wani
That's not a verb I recognise.

I beg your pardon?

>wait
Time passes.

>e
You can't go that way.

* * *

>w
You can't go that way.

>wait
Time passes.

>s
DNA Beach
Surfs-up! Seems as though everyone's at the beach today. A sign shows the reports of the day. Many beach blankets cover the bed of sand. A red box lies underneath the analysis sign.

You can see Red Box (closed) here.

>s
Aurora Walk
This seems to be the main walkway for many people. It is busy and lots of rubbish is littered on the ground. A trash can is always available yet no one has the decency to throw the trash into it. The ground is made up of a thick green cushiony pad.

>wait
Time passes.

>wait
Time passes.

>w
Tech Building
A Medium Sized robot is the only thing on the floor around the building. Programers are focused on their work on building more of these robots.

You can see Medium Sized Robot here.

>x robot
 A metal robot with cylindrical pieces of tin stuck to it. The robot is able to do things such as walking, and say monotonous things. It doesn't seem to have batteries though.

>it
That's not a verb I recognise.

>….x medium sized robotar䐨곕滥ぶ褐ݦd⁮牴楡獮栠獩愠浲⹹丠瑯楨杮⊐֚⅀饟㲨곕ތŀ猅潣敲 䐨곕ኀŀ
That's not a verb I recognise.

>x medum sized robot
You can't see any such thing.

>x medium sized robot
 A metal robot with cylindrical pieces of tin stuck to it. The robot is able to do things such as walking, and say monotonous things. It doesn't seem to have batteries though.

>look
Tech Building
A Medium Sized robot is the only thing on the floor around the building. Programers are focused on their work on building more of these robots.

You can see Medium Sized Robot here.

>x Medium Sized Robot
 A metal robot with cylindrical pieces of tin stuck to it. The robot is able to do things such as walking, and say monotonous things. It doesn't seem to have batteries though.

>ohhhh shittt jon u magic m used to
That's not a verb I recognise.

>jonused to
That's not a verb I recognise.

>x robot
 A metal robot with cylindrical pieces of tin stuck to it. The robot is able to do things such as walking, and say monotonous things. It doesn't seem to have batteries though.

>take battereis
You can't see any such thing.

>s
Garage
This must be someone's garage. Definately not yours, that's for sure. Many intricate tools and devices hang from the walls and racks. A marvelous car is parked in the middle of it!

Such an incredible piece of work! The car is slick and skinny. A white coat of paint is layered on the whole car and you can even see your own reflection! A black trim goes all around the sides, with blue tinted windows. Surprisingly there are no tires, and exhaust pipes stick out from the back of the car A fairly large bar code is inscribed on the trunk.

>e
Lab Room
It is very gloomy in here with its spherical lights. You can vaguely see equpiment that you have in your very own lab room as well. The desks and chairs are covered in cob webs. The lab shelves are high up with shiny objects on the top. The walls are completely white with faded designs on them. An orange backpack is in here as well so that you can put all your findings into it and take them back home with you.

>take batteries
You pick up the electrical batteries.

>w
Garage
This must be someone's garage. Definately not yours, that's for sure. Many intricate tools and devices hang from the walls and racks. A marvelous car is parked in the middle of it!

Such an incredible piece of work! The car is slick and skinny. A white coat of paint is layered on the whole car and you can even see your own reflection! A black trim goes all around the sides, with blue tinted windows. Surprisingly there are no tires, and exhaust pipes stick out from the back of the car A fairly large bar code is inscribed on the trunk.

>e
Lab Room
It is very gloomy in here with its spherical lights. You can vaguely see equpiment that you have in your very own lab room as well. The desks and chairs are covered in cob webs. The lab shelves are high up with shiny objects on the top. The walls are completely white with faded designs on them. An orange backpack is in here as well so that you can put all your findings into it and take them back home with you.

>w
Garage
This must be someone's garage. Definately not yours, that's for sure. Many intricate tools and devices hang from the walls and racks. A marvelous car is parked in the middle of it!

Such an incredible piece of work! The car is slick and skinny. A white coat of paint is layered on the whole car and you can even see your own reflection! A black trim goes all around the sides, with blue tinted windows. Surprisingly there are no tires, and exhaust pipes stick out from the back of the car A fairly large bar code is inscribed on the trunk.

* * *

>n
Tech Building
A Medium Sized robot is the only thing on the floor around the building. Programers are focused on their work on building more of these robots.

You can see Medium Sized Robot here.

>x robot
 A metal robot with cylindrical pieces of tin stuck to it. The robot is able to do things such as walking, and say monotonous things. It doesn't seem to have batteries though.

>give battereis to robot
You can't see any such thing.

>give batteries to robot
The robot starts to dance to the tune of Call Me Maybe by Carly Rae Jepson.

>x robot
  A metal robot with cylindrical pieces of tin stuck to it. The robot is able to do things such as walking, and say monotonous things. Man, that thing could dance!

* * *

>ast
That's not a verb I recognise.

>east
The Pristine Library
The library is embedded with silver crystals all around the walls. There are about ten different shelves that contain thousands of historic books that date back to your time. One of them is a black book that seems to be jutting out a little too far than the others though. A clear glass door is on the far side of the library along with a painting of a prestigious man.

>west
Lab Room
It is very gloomy in here with its spherical lights. You can vaguely see equpiment that you have in your very own lab room as well. The desks and chairs are covered in cob webs, with different flasks that contain unique chemicals inside them. The lab shelves are high up with shiny objects on the top. The walls are completely white with faded designs on them. An orange container is in here as well so that you can put all your findings into here and take them back home with you.

>west
Garage
This must be someone's garage. Definately not yours, that's for sure. Many intricate tools and devices hang from the walls and racks. A marvelous car is parked in the middle of it!

Such an incredible piece of work! The car is slick and skinny. A white coat of paint is layered on the whole car and you can even see your own reflection! A black trim goes all around the sides, with blue tinted windows. Surprisingly there are no tires, and exhaust pipes stick out from the back of the car A fairly large bar code is inscribed on the trunk.

>east
Lab Room
It is very gloomy in here with its spherical lights. You can vaguely see equpiment that you have in your very own lab room as well. The desks and chairs are covered in cob webs, with different flasks that contain unique chemicals inside them. The lab shelves are high up with shiny objects on the top. The walls are completely white with faded designs on them. An orange container is in here as well so that you can put all your findings into here and take them back home with you.

>south
Outback Dump
A room made specially for trash and filthy chemicals. It reeks of carbon and a large dumpster is in the center of the room. A bunch of dead spiders are scattered all over the place. Disgusting.

>north
Lab Room
It is very gloomy in here with its spherical lights. You can vaguely see equpiment that you have in your very own lab room as well. The desks and chairs are covered in cob webs, with different flasks that contain unique chemicals inside them. The lab shelves are high up with shiny objects on the top. The walls are completely white with faded designs on them. An orange container is in here as well so that you can put all your findings into here and take them back home with you.

>w
Garage
This must be someone's garage. Definately not yours, that's for sure. Many intricate tools and devices hang from the walls and racks. A marvelous car is parked in the middle of it!

Such an incredible piece of work! The car is slick and skinny. A white coat of paint is layered on the whole car and you can even see your own reflection! A black trim goes all around the sides, with blue tinted windows. Surprisingly there are no tires, and exhaust pipes stick out from the back of the car A fairly large bar code is inscribed on the trunk.

>n
Tech Building
Miniature sized robots cover the floor around the building. Programers focused on their work on building more of these tiny robots.

>w
Old Thirft Shop
An old-school yet reimaged look of a Thirft Shop. The racks of clothes and hangers automatically rotate once you are done looking at them. Most of the stuff here dates back to 2010. Looks fairly brand new and in style.

>s
Floating Sidewalk
A luminated clear pathway slowly elevates as you walk farther up onto it. Metal handbars line the edges of the clear floating path. It feels as if you're walking on a cloud, but looks like a beam of light!

>e
Garage
This must be someone's garage. Definately not yours, that's for sure. Many intricate tools and devices hang from the walls and racks. A marvelous car is parked in the middle of it!

Such an incredible piece of work! The car is slick and skinny. A white coat of paint is layered on the whole car and you can even see your own reflection! A black trim goes all around the sides, with blue tinted windows. Surprisingly there are no tires, and exhaust pipes stick out from the back of the car A fairly large bar code is inscribed on the trunk.

>n
Tech Building
Miniature sized robots cover the floor around the building. Programers focused on their work on building more of these tiny robots.

>n
Jump
A long and twelve foot wall that juts out of the land connected to the beach.

>n
You can't go that way.

>e
DNA Beach
Surfs-up! Seems as though everyone's at the beach today. A sign shows the reports of the day. Many blankets and umbrella-like equipment cover the bed of sand. A red box lies underneath the sign.

>e
Cruising Shack
An open cabin made out of wooden planks. A cashier runs the whole place, while people go in and out, grabbing beach gear and equipment from the automatic moving shelf.

You realize that you have only fifteen more minutes to get the cat into his carrier.

>s
You can't go that way.

>w
DNA Beach
Surfs-up! Seems as though everyone's at the beach today. A sign shows the reports of the day. Many blankets and umbrella-like equipment cover the bed of sand. A red box lies underneath the sign.

>s
Aurora Walk
This seems to be the main walkway for many people. It is busy and lots of trash is littered on the ground. The ground is made up of a thick green cushiony pad.

>e
Facial Salon
A pretty beautician in the back of the counter is waiting to greet people as they walk through. The aroma of strawberry surrounds the salon. Lots of silk and hair is scattered all over the checker-board floor and tabletops. Black leather seats around the mirrors make up almost the entire salon.

>s
The Pristine Library
The library is embedded with silver crystals all around the walls. There are about ten different shelves that contain thousands of historic books that date back to your time. One of them is a black book that seems to be jutting out a little too far than the others though. A clear glass door is on the far side of the library along with a painting of a prestigious man.

>w
Lab Room
It is very gloomy in here with its spherical lights. You can vaguely see equpiment that you have in your very own lab room as well. The desks and chairs are covered in cob webs, with different flasks that contain unique chemicals inside them. The lab shelves are high up with shiny objects on the top. The walls are completely white with faded designs on them. An orange container is in here as well so that you can put all your findings into here and take them back home with you.

>w
Garage
This must be someone's garage. Definately not yours, that's for sure. Many intricate tools and devices hang from the walls and racks. A marvelous car is parked in the middle of it!

Such an incredible piece of work! The car is slick and skinny. A white coat of paint is layered on the whole car and you can even see your own reflection! A black trim goes all around the sides, with blue tinted windows. Surprisingly there are no tires, and exhaust pipes stick out from the back of the car A fairly large bar code is inscribed on the trunk.

>s
Obscure Parking Lot
An eighteen foot parking structure that allows you to park your car whenever you want.

Your exhaustion is threatening to send you crashing to the floor, unable to move.

>w
Elevator Shaft
Watch out! Yellow tape borders the edges of the elevator. Seems as though the elevator is out of function.

>e
Obscure Parking Lot
An eighteen foot parking structure that allows you to park your car whenever you want.

>e
Skyscraper 057
The largest building in the vicinity. Two steel doors open and close as you enter. The Skyscraper is filled with many people trying to buy and sell their products amongst many business owners.  Low square desks and pillows make up the whole floor. A young little girl is huddled in the corner as tears rush down her face. Where are her parents? How strange.

>n
Stairway
Just an empty stairway. Wonder where this leads to.

>n
Skyscraper View
What an amazing sight to see. Long metal poles stretch across the edges of the skyscraper for safety. There's a nice breeze at the top of the Skyscraper. You can see almost everything from here, how fantastic. Just don't look down.

>s
Stairway
Just an empty stairway. Wonder where this leads to.

>s
Skyscraper 057
The largest building in the vicinity. Two steel doors open and close as you enter. The Skyscraper is filled with many people trying to buy and sell their products amongst many business owners.  Low square desks and pillows make up the whole floor. A young little girl is huddled in the corner as tears rush down her face. Where are her parents? How strange. 

You are about to drop dead of exhaustion. "The cats will be the death of me," you always said.

>s
You can't go that way.

>e
Plaza Streets
People hustle and bustle around the plaza. A large fish fountain with a statue of a person is located in the center of it. The ground is tiled with black and blue cement around the plaza. What a sight.

>n
You can't go that way.

You stumble to your knees and then collapse on the floor, quite surprised to find that the phrase "drop dead of exhaustion" can be literally true.

>e
You can't go that way.

* * *

>w
You can't go that way.

>n
Plaza Streets
People hustle and bustle around the plaza. A large fish fountain with a statue of a person is located in the center of it. The ground is tiled with black and blue cement around the plaza. What a sight.

>w
Skyscraper 057
The largest building in the vicinity. Two steel doors open and close as you enter. The Skyscraper is filled with many people trying to buy and sell their products amongst many business owners.  Low square desks and pillows make up the whole floor. A young little girl is huddled in the corner as tears rush down her face. Where are her parents? How strange.