You are an intelligent scientist who has invented a prototype watch that allows you to travel 40 years into the future. You have exactly an hour and a half in the future day before your watch teleports you back home. In the mean time, you can do anything your heart desires, but use your time wisely!

You have successfully teleported into the future. Keep an eye on your watch at all times.

"Whoa!!!" you say. "I guess this is what my laboratory will look like 40 years from now… How magnificent!"

Into The Future
An Interactive Fiction by Tyler Makabe
Release 1 / Serial number 130303 / Inform 7 build 6G60 (I6/v6.32 lib 6/12N) SD

Lab Room
It is very gloomy. The spherical lights are dark blue. You can vaguely see equpiment that you have in your very own lab room. The desks and chairs are covered in cob webs, with different flasks that contain unique chemicals inside them. The shelves are high up with shiny objects on the top. Other than that, there is nothing so futuristic about this room.

>take all
Hey stop that! All is disabled.

* * *

>east
Pristine Library
s

>north
Fresh Barber Shop
s

* * *

>east
Pristine Library
s

>west
Lab
s

* * *

>west
Garage
s

s

>ride XD4
That's not a verb I recognise.